Team,Game,Opp Team,GP,SAT For,SAT Agst,SAT,SAT Tied,SAT Ahead,SAT Behind,SAT Close,USAT For,USAT Agst,USAT,USAT Tied,USAT Ahead,USAT Behind,USAT Close
Calgary Flames,2013/02/02  vs. CHI,CHI,1,61,41,20,8,1,11,8,44,27,17,10,1,6,10
Pittsburgh Penguins,2013/04/23  vs. BUF,BUF,1,61,49,12,15,0,-3,12,42,36,6,7,0,-1,5
Los Angeles Kings,2013/03/07  vs. DAL,DAL,1,50,35,15,6,1,8,10,40,28,12,5,1,6,7
Columbus Blue Jackets,2013/04/09  vs. SJS,SJS,1,41,51,-10,-3,-7,0,-5,33,39,-6,0,-6,0,-3
Detroit Red Wings,2013/03/16  vs. VAN,VAN,1,42,43,-1,-1,1,-1,0,31,35,-4,-7,5,-2,-6
San Jose Sharks,2013/01/20  vs. CGY,CGY,1,41,51,-10,-8,-6,4,1,28,39,-11,-8,-2,-1,-4
New York Rangers,2013/02/23  vs. MTL,MTL,1,50,46,4,8,0,-4,5,34,29,5,4,0,1,3
Colorado Avalanche,2013/03/28  vs. VAN,VAN,1,48,43,5,-5,0,10,-1,33,29,4,-4,0,8,-1
Pittsburgh Penguins,2013/02/02  vs. NJD,NJD,1,49,33,16,2,14,0,8,37,20,17,4,13,0,10
New York Islanders,2013/04/02  vs. WPG,WPG,1,64,45,19,16,2,1,20,49,30,19,12,6,1,15
New Jersey Devils,2013/03/23  vs. FLA,FLA,1,37,43,-6,-9,3,0,-5,30,29,1,-5,6,0,-1
Minnesota Wild,2013/02/21  vs. EDM,EDM,1,51,48,3,0,4,-1,-1,33,36,-3,-1,-1,-1,-2
Philadelphia Flyers,2013/04/18  vs. NJD,NJD,1,32,48,-16,-9,0,-7,-15,23,34,-11,-2,0,-9,-8
Pittsburgh Penguins,2013/02/24  vs. TBL,TBL,1,36,46,-10,-2,-8,0,-4,24,31,-7,-2,-5,0,-6
Colorado Avalanche,2013/03/03  vs. CBJ,CBJ,1,30,40,-10,-12,2,0,-12,22,28,-6,-8,2,0,-8
Washington Capitals,2013/03/10  vs. NYR,NYR,1,40,46,-6,-10,6,-2,-5,25,35,-10,-7,2,-5,-6
Boston Bruins,2013/02/10  vs. BUF,BUF,1,56,34,22,22,0,0,23,40,27,13,9,4,0,12
New York Islanders,2013/03/05  vs. MTL,MTL,1,34,46,-12,1,-6,-7,-2,22,32,-10,-1,-5,-4,-2
Winnipeg Jets,2013/03/26  vs. CAR,CAR,1,63,64,-1,-6,6,-1,-1,49,44,5,-4,8,1,1
Florida Panthers,2013/01/22  vs. MTL,MTL,1,27,35,-8,-4,0,-4,-15,20,24,-4,-4,0,0,-10
St. Louis Blues,2013/02/17  vs. VAN,VAN,1,35,46,-11,-5,-2,-4,-9,25,31,-6,-6,-1,1,-5
St. Louis Blues,2013/01/31  vs. CBJ,CBJ,1,26,33,-7,-1,-6,0,6,26,24,2,-1,3,0,6
Dallas Stars,2013/03/29  vs. MIN,MIN,1,39,55,-16,2,-18,0,-10,26,38,-12,0,-12,0,-5
Toronto Maple Leafs,2013/02/11  vs. PHI,PHI,1,43,55,-12,2,-17,3,6,30,42,-12,2,-12,-2,1
Chicago Blackhawks,2013/01/26  vs. CBJ,CBJ,1,27,27,0,6,-2,-4,-2,19,17,2,2,3,-3,-2
Tampa Bay Lightning,2013/02/14  vs. WSH,WSH,1,44,66,-22,-1,0,-21,-13,36,49,-13,0,0,-13,-9
Nashville Predators,2013/03/17  vs. EDM,EDM,1,43,33,10,4,0,6,6,35,22,13,9,0,4,9
Pittsburgh Penguins,2013/04/13  vs. FLA,FLA,1,34,43,-9,0,-9,0,-2,26,28,-2,-2,0,0,1
Minnesota Wild,2013/01/25  vs. DET,DET,1,26,34,-8,1,0,-9,0,18,29,-11,1,0,-12,-3
Montreal Canadiens,2013/01/19  vs. TOR,TOR,1,35,31,4,1,0,3,-4,24,26,-2,1,0,-3,-4
St. Louis Blues,2013/02/20  vs. COL,COL,1,60,37,23,23,0,0,23,42,22,20,20,0,0,20
Tampa Bay Lightning,2013/04/18  vs. MTL,MTL,1,53,48,5,-6,0,11,-1,41,36,5,-7,0,12,-2
Los Angeles Kings,2013/02/02  vs. ANA,ANA,1,54,28,26,11,0,15,17,41,22,19,10,0,9,14
Nashville Predators,2013/04/04  vs. CBJ,CBJ,1,44,60,-16,-6,0,-10,-10,32,44,-12,-1,0,-11,-3
Pittsburgh Penguins,2013/01/19  vs. PHI,PHI,1,44,36,8,1,7,0,-6,35,26,9,1,8,0,-2
Dallas Stars,2013/02/02  vs. PHX,PHX,1,36,42,-6,-1,0,-5,-4,23,30,-7,-4,0,-3,-5
Minnesota Wild,2013/03/25  vs. DAL,DAL,1,54,40,14,4,7,3,9,44,27,17,8,5,4,14
Boston Bruins,2013/01/29  vs. NJD,NJD,1,42,31,11,3,0,8,1,29,21,8,0,0,8,-1
Tampa Bay Lightning,2013/04/21  vs. CAR,CAR,1,52,35,17,0,0,17,4,44,31,13,0,0,13,1
Phoenix Coyotes,2013/01/20  vs. CHI,CHI,1,42,48,-6,-1,-4,-1,-5,35,35,0,2,-1,-1,1
Carolina Hurricanes,2013/03/03  vs. FLA,FLA,1,35,47,-12,-13,1,0,-12,25,39,-14,-11,-3,0,-10
Nashville Predators,2013/03/19  vs. CBJ,CBJ,1,46,37,9,-1,0,10,-5,39,26,13,1,0,12,-4
Detroit Red Wings,2013/04/01  vs. COL,COL,1,33,27,6,2,4,0,2,29,21,8,3,5,0,4
Ottawa Senators,2013/04/07  vs. FLA,FLA,1,56,29,27,27,-3,3,24,46,22,24,24,-2,2,22
Minnesota Wild,2013/03/09  vs. NSH,NSH,1,35,39,-4,-7,3,0,-2,29,29,0,-1,1,0,3
Edmonton Oilers,2013/02/25  vs. CHI,CHI,1,20,52,-32,-30,-2,0,-33,16,34,-18,-17,-1,0,-20
Chicago Blackhawks,2013/03/01  vs. CBJ,CBJ,1,58,45,13,12,5,-4,10,43,31,12,7,6,-1,8
Boston Bruins,2013/01/21  vs. WPG,WPG,1,48,51,-3,-1,0,-2,-3,34,34,0,3,0,-3,0
Nashville Predators,2013/04/12  vs. DAL,DAL,1,39,25,14,-4,0,18,-6,28,20,8,-3,0,11,-7
Los Angeles Kings,2013/04/04  vs. MIN,MIN,1,32,38,-6,1,-7,0,2,24,29,-5,0,-5,0,1
Dallas Stars,2013/04/03  vs. ANA,ANA,1,49,36,13,-6,0,19,7,34,30,4,-8,0,12,1
Philadelphia Flyers,2013/02/27  vs. WSH,WSH,1,61,40,21,0,21,0,4,42,25,17,0,17,0,4
Montreal Canadiens,2013/02/09  vs. TOR,TOR,1,38,40,-2,3,0,-5,-3,27,29,-2,2,0,-4,-3
San Jose Sharks,2013/04/01  vs. VAN,VAN,1,49,62,-13,5,-18,0,6,40,37,3,9,-6,0,10
San Jose Sharks,2013/03/06  vs. CGY,CGY,1,50,42,8,-3,0,11,-4,37,35,2,-2,0,4,-6
New Jersey Devils,2013/04/04  vs. BOS,BOS,1,58,42,16,11,0,5,7,46,29,17,10,0,7,8
Detroit Red Wings,2013/04/11  vs. SJS,SJS,1,41,34,7,5,-1,3,8,28,29,-1,1,-1,-1,0
Ottawa Senators,2013/04/11  vs. PHI,PHI,1,56,33,23,14,9,0,24,42,18,24,16,8,0,24
Florida Panthers,2013/02/09  vs. WSH,WSH,1,40,46,-6,-1,0,-5,0,23,31,-8,0,0,-8,0
Buffalo Sabres,2013/02/02  vs. MTL,MTL,1,36,41,-5,-14,0,9,-12,27,31,-4,-12,0,8,-11
Pittsburgh Penguins,2013/03/22  vs. NYI,NYI,1,51,61,-10,-7,-4,1,-6,32,44,-12,-11,-4,3,-8
Edmonton Oilers,2013/04/26  vs. MIN,MIN,1,37,66,-29,1,-30,0,-5,27,48,-21,1,-22,0,-3
Phoenix Coyotes,2013/04/22  vs. DET,DET,1,47,36,11,0,0,11,6,38,30,8,0,0,8,6
Pittsburgh Penguins,2013/04/03  vs. NYR,NYR,1,39,56,-17,-2,0,-15,-3,31,44,-13,-1,0,-12,-2
Columbus Blue Jackets,2013/04/04  vs. NSH,NSH,1,60,44,16,6,10,0,10,44,32,12,1,11,0,3
Ottawa Senators,2013/04/16  vs. CAR,CAR,1,37,50,-13,-6,-7,0,-3,30,35,-5,-6,1,0,-2
Minnesota Wild,2013/04/13  vs. CBJ,CBJ,1,48,33,15,7,-4,12,9,39,21,18,7,0,11,11
Tampa Bay Lightning,2013/02/02  vs. NYR,NYR,1,46,51,-5,-10,-7,12,-17,36,43,-7,-11,-5,9,-16
New York Islanders,2013/03/07  vs. NYR,NYR,1,51,70,-19,-2,-17,0,-16,33,53,-20,0,-20,0,-17
Chicago Blackhawks,2013/02/02  vs. CGY,CGY,1,41,61,-20,-8,-11,-1,-8,27,44,-17,-10,-6,-1,-10
Minnesota Wild,2013/01/20  vs. DAL,DAL,1,40,47,-7,4,-11,0,-13,32,28,4,4,0,0,-5
Colorado Avalanche,2013/04/02  vs. NSH,NSH,1,42,55,-13,-8,-5,0,-8,29,43,-14,-10,-4,0,-10
Minnesota Wild,2013/03/05  vs. CHI,CHI,1,32,51,-19,-2,-8,-9,-12,27,37,-10,-3,-5,-2,-10
Chicago Blackhawks,2013/03/10  vs. EDM,EDM,1,53,32,21,-2,0,23,-4,39,24,15,-1,0,16,-2
Anaheim Ducks,2013/03/31  vs. CBJ,CBJ,1,50,26,24,21,0,3,22,37,20,17,16,0,1,15
Tampa Bay Lightning,2013/03/14  vs. NYI,NYI,1,40,47,-7,-14,0,7,-12,28,35,-7,-11,0,4,-7
Los Angeles Kings,2013/02/07  vs. NSH,NSH,1,57,19,38,1,0,37,14,39,15,24,0,0,24,7
Washington Capitals,2013/03/31  vs. PHI,PHI,1,48,40,8,2,2,4,15,34,29,5,2,3,0,8
Colorado Avalanche,2013/03/23  vs. DAL,DAL,1,61,40,21,0,0,21,2,41,28,13,0,0,13,2
Calgary Flames,2013/03/22  vs. CBJ,CBJ,1,40,42,-2,5,0,-7,-2,29,35,-6,2,0,-8,-4
Buffalo Sabres,2013/03/31  vs. BOS,BOS,1,42,52,-10,-9,0,-1,-9,32,39,-7,-5,0,-2,-5
Columbus Blue Jackets,2013/04/05  vs. STL,STL,1,39,30,9,-1,0,10,2,29,21,8,1,0,7,3
Columbus Blue Jackets,2013/03/22  vs. CGY,CGY,1,42,40,2,-5,7,0,2,35,29,6,-2,8,0,4
Los Angeles Kings,2013/04/11  vs. COL,COL,1,44,40,4,7,-3,0,8,35,33,2,8,-6,0,9
San Jose Sharks,2013/03/27  vs. ANA,ANA,1,42,54,-12,0,-12,0,3,31,26,5,0,5,0,2
Florida Panthers,2013/02/22  vs. PIT,PIT,1,36,47,-11,-9,1,-3,-8,29,38,-9,-9,1,-1,-8
Winnipeg Jets,2013/03/05  vs. FLA,FLA,1,47,41,6,-1,0,7,-10,41,33,8,0,0,8,-5
Buffalo Sabres,2013/03/16  vs. OTT,OTT,1,36,45,-9,4,-5,-8,-1,27,34,-7,3,-7,-3,-3
San Jose Sharks,2013/03/18  vs. ANA,ANA,1,58,35,23,16,0,7,14,43,29,14,9,0,5,6
Dallas Stars,2013/03/18  vs. CGY,CGY,1,44,38,6,16,-10,0,18,32,22,10,10,0,0,11
New Jersey Devils,2013/02/16  vs. NYI,NYI,1,44,37,7,3,0,4,2,29,30,-1,1,0,-2,0
Minnesota Wild,2013/02/28  vs. PHX,PHX,1,33,50,-17,-4,-13,0,-13,22,38,-16,-3,-13,0,-9
San Jose Sharks,2013/02/02  vs. NSH,NSH,1,34,34,0,6,0,-6,6,25,23,2,8,0,-6,8
Calgary Flames,2013/03/27  vs. COL,COL,1,37,42,-5,-1,-4,0,7,27,31,-4,-1,-3,0,0
New Jersey Devils,2013/04/25  vs. PIT,PIT,1,41,22,19,14,3,2,14,37,18,19,16,2,1,17
Columbus Blue Jackets,2013/04/27  vs. NSH,NSH,1,58,36,22,1,4,17,7,49,28,21,3,4,14,8
Los Angeles Kings,2013/04/27  vs. SJS,SJS,1,57,43,14,12,2,0,25,45,31,14,12,2,0,22
Colorado Avalanche,2013/01/19  vs. MIN,MIN,1,43,36,7,-1,9,-1,6,29,31,-2,-1,6,-7,3
St. Louis Blues,2013/04/23  vs. COL,COL,1,52,29,23,0,23,0,6,40,19,21,-2,23,0,5
Los Angeles Kings,2013/03/23  vs. VAN,VAN,1,40,19,21,2,0,19,15,31,16,15,2,0,13,8
Winnipeg Jets,2013/02/19  vs. BUF,BUF,1,50,48,2,0,2,0,1,36,32,4,0,4,0,2
Washington Capitals,2013/01/24  vs. MTL,MTL,1,47,24,23,8,0,15,9,34,18,16,6,0,10,7
Colorado Avalanche,2013/02/06  vs. ANA,ANA,1,61,40,21,-2,0,23,6,41,27,14,-1,0,15,5
Carolina Hurricanes,2013/04/20  vs. PHI,PHI,1,46,52,-6,-13,0,7,-12,37,47,-10,-13,0,3,-15
Carolina Hurricanes,2013/03/21  vs. NJD,NJD,1,45,40,5,1,0,4,-5,32,25,7,2,0,5,8
Columbus Blue Jackets,2013/03/29  vs. CGY,CGY,1,43,56,-13,2,-15,0,-1,32,38,-6,1,-7,0,0
Buffalo Sabres,2013/02/19  vs. WPG,WPG,1,48,50,-2,0,0,-2,-1,32,36,-4,0,0,-4,-2
Washington Capitals,2013/02/09  vs. FLA,FLA,1,46,40,6,1,5,0,0,31,23,8,0,8,0,0
Edmonton Oilers,2013/03/17  vs. NSH,NSH,1,33,43,-10,-4,-6,0,-6,22,35,-13,-9,-4,0,-9
Nashville Predators,2013/01/19  vs. CBJ,CBJ,1,49,36,13,7,6,0,13,40,28,12,8,4,0,12
Colorado Avalanche,2013/04/10  vs. ANA,ANA,1,44,36,8,1,7,0,3,30,23,7,0,7,0,0
San Jose Sharks,2013/01/27  vs. VAN,VAN,1,18,36,-18,0,-18,0,-3,12,25,-13,0,-13,0,-3
Nashville Predators,2013/02/10  vs. CHI,CHI,1,39,44,-5,-7,0,2,-8,26,33,-7,-7,0,0,-8
Edmonton Oilers,2013/04/03  vs. CGY,CGY,1,45,40,5,11,-4,-2,9,36,30,6,8,-3,1,9
Boston Bruins,2013/01/31  vs. BUF,BUF,1,61,41,20,17,2,1,18,41,35,6,5,0,1,6
San Jose Sharks,2013/04/27  vs. LAK,LAK,1,43,57,-14,-12,0,-2,-25,31,45,-14,-12,0,-2,-22
Chicago Blackhawks,2013/01/22  vs. STL,STL,1,36,49,-13,2,-15,0,-3,29,33,-4,3,-7,0,-1
Columbus Blue Jackets,2013/04/21  vs. SJS,SJS,1,45,64,-19,-6,-13,0,-6,28,46,-18,-9,-9,0,-5
Boston Bruins,2013/04/17  vs. BUF,BUF,1,61,26,35,4,31,0,26,49,21,28,6,22,0,22
Nashville Predators,2013/01/26  vs. ANA,ANA,1,31,45,-14,-1,-13,0,-15,22,31,-9,-3,-6,0,-10
Calgary Flames,2013/02/23  vs. MIN,MIN,1,41,46,-5,2,-7,0,-1,32,34,-2,5,-7,0,0
Nashville Predators,2013/03/25  vs. EDM,EDM,1,38,34,4,6,-3,1,4,26,25,1,1,-1,1,2
New York Rangers,2013/04/18  vs. FLA,FLA,1,47,50,-3,0,-3,0,7,39,38,1,1,0,0,6
Tampa Bay Lightning,2013/04/13  vs. WSH,WSH,1,54,39,15,3,0,12,-5,37,32,5,0,0,5,-8
New York Rangers,2013/03/24  vs. WSH,WSH,1,41,49,-8,3,0,-11,4,33,30,3,8,0,-5,11
Carolina Hurricanes,2013/02/09  vs. PHI,PHI,1,54,46,8,5,1,2,7,35,36,-1,1,1,-3,2
Minnesota Wild,2013/04/21  vs. CGY,CGY,1,53,39,14,7,0,7,9,40,27,13,8,0,5,9
Minnesota Wild,2013/03/20  vs. DET,DET,1,21,41,-20,1,-21,0,-3,15,34,-19,0,-19,0,-2
Washington Capitals,2013/03/22  vs. WPG,WPG,1,25,46,-21,-6,-15,0,-13,19,34,-15,-6,-9,0,-10
Los Angeles Kings,2013/03/25  vs. CHI,CHI,1,41,31,10,9,3,-2,11,36,24,12,11,2,-1,12
New York Rangers,2013/04/25  vs. CAR,CAR,1,57,34,23,3,7,13,4,41,23,18,2,8,8,4
Montreal Canadiens,2013/03/03  vs. BOS,BOS,1,38,52,-14,0,-15,1,-5,27,37,-10,1,-8,-3,-4
New Jersey Devils,2013/02/12  vs. CAR,CAR,1,32,27,5,2,-1,4,-1,27,19,8,4,0,4,2
New York Islanders,2013/02/14  vs. NYR,NYR,1,47,51,-4,-5,2,-1,-6,35,36,-1,-2,2,-1,-3
Vancouver Canucks,2013/04/18  vs. DAL,DAL,1,63,40,23,11,6,6,17,53,33,20,10,7,3,17
New Jersey Devils,2013/03/09  vs. CAR,CAR,1,51,32,19,-4,0,23,-3,37,26,11,-2,0,13,-1
Winnipeg Jets,2013/01/27  vs. NYI,NYI,1,59,59,0,4,-11,7,-6,47,43,4,2,-4,6,0
Chicago Blackhawks,2013/04/07  vs. NSH,NSH,1,60,33,27,10,18,-1,24,44,23,21,7,17,-3,18
Florida Panthers,2013/03/16  vs. NYI,NYI,1,60,48,12,4,0,8,3,44,31,13,4,0,9,2
Ottawa Senators,2013/03/25  vs. NJD,NJD,1,26,58,-32,-12,-20,0,-29,18,44,-26,-9,-17,0,-23
Nashville Predators,2013/02/02  vs. SJS,SJS,1,34,34,0,-6,6,0,-6,23,25,-2,-8,6,0,-8
New York Rangers,2013/03/19  vs. NJD,NJD,1,33,44,-11,-6,-5,0,-7,29,33,-4,-3,-1,0,-4
Buffalo Sabres,2013/01/25  vs. CAR,CAR,1,40,44,-4,-7,1,2,-7,33,41,-8,-9,1,0,-9
Florida Panthers,2013/03/08  vs. WPG,WPG,1,46,43,3,-2,0,5,0,39,28,11,5,0,6,8
Colorado Avalanche,2013/02/24  vs. ANA,ANA,1,45,45,0,4,-4,0,-4,28,35,-7,-2,-5,0,-9
New York Islanders,2013/03/22  vs. PIT,PIT,1,61,51,10,7,-1,4,6,44,32,12,11,-3,4,8
Columbus Blue Jackets,2013/03/09  vs. DET,DET,1,28,33,-5,3,-8,0,1,23,28,-5,2,-7,0,1
Pittsburgh Penguins,2013/02/05  vs. NYI,NYI,1,35,38,-3,-1,-2,0,-5,27,27,0,0,0,0,-4
Los Angeles Kings,2013/04/24  vs. DET,DET,1,32,58,-26,-23,-6,3,-29,28,47,-19,-17,-4,2,-21
Washington Capitals,2013/03/17  vs. BUF,BUF,1,45,42,3,3,0,0,2,29,32,-3,1,-4,0,0
New York Rangers,2013/02/14  vs. NYI,NYI,1,51,47,4,5,1,-2,6,36,35,1,2,1,-2,3
Vancouver Canucks,2013/01/23  vs. CGY,CGY,1,58,38,20,19,1,0,20,44,29,15,15,0,0,15
Colorado Avalanche,2013/03/18  vs. CHI,CHI,1,38,54,-16,1,0,-17,-3,24,38,-14,2,0,-16,-2
Toronto Maple Leafs,2013/04/10  vs. NYR,NYR,1,35,49,-14,-3,-1,-10,-11,29,33,-4,2,1,-7,-1
New York Islanders,2013/02/28  vs. TOR,TOR,1,52,51,1,-7,2,6,-3,36,37,-1,-6,1,4,-3
Toronto Maple Leafs,2013/02/19  vs. TBL,TBL,1,46,33,13,9,0,4,13,32,24,8,9,0,-1,6
Edmonton Oilers,2013/02/09  vs. DET,DET,1,30,48,-18,-11,0,-7,-11,23,34,-11,-11,0,0,-10
Phoenix Coyotes,2013/01/28  vs. NSH,NSH,1,36,40,-4,-1,-3,0,-2,29,30,-1,0,-1,0,-1
Boston Bruins,2013/03/03  vs. MTL,MTL,1,52,38,14,0,-1,15,5,37,27,10,-1,3,8,4
Anaheim Ducks,2013/04/01  vs. DAL,DAL,1,48,40,8,-1,9,0,0,35,31,4,-1,5,0,-1
Vancouver Canucks,2013/04/10  vs. CGY,CGY,1,43,52,-9,-13,1,3,-10,29,44,-15,-17,0,2,-15
Washington Capitals,2013/02/27  vs. PHI,PHI,1,40,61,-21,0,0,-21,-4,25,42,-17,0,0,-17,-4
Boston Bruins,2013/02/12  vs. NYR,NYR,1,45,30,15,5,0,10,9,26,23,3,5,0,-2,5
Phoenix Coyotes,2013/02/09  vs. SJS,SJS,1,38,53,-15,-15,0,0,-15,29,37,-8,-8,0,0,-8
Edmonton Oilers,2013/03/28  vs. CBJ,CBJ,1,42,52,-10,5,-3,-12,-2,29,38,-9,1,-3,-7,-2
Vancouver Canucks,2013/03/21  vs. PHX,PHX,1,32,47,-15,2,-17,0,-11,28,32,-4,4,-8,0,-1
Montreal Canadiens,2013/03/16  vs. NJD,NJD,1,29,46,-17,-9,-8,0,-16,24,32,-8,-5,-3,0,-9
Carolina Hurricanes,2013/04/25  vs. NYR,NYR,1,34,57,-23,-3,-13,-7,-4,23,41,-18,-2,-8,-8,-4
Detroit Red Wings,2013/04/22  vs. PHX,PHX,1,36,47,-11,0,-11,0,-6,30,38,-8,0,-8,0,-6
Boston Bruins,2013/03/25  vs. TOR,TOR,1,54,26,28,13,0,15,25,39,20,19,10,0,9,18
Dallas Stars,2013/04/09  vs. LAK,LAK,1,44,48,-4,-1,-4,1,0,33,36,-3,-2,-1,0,-2
Florida Panthers,2013/03/23  vs. NJD,NJD,1,43,37,6,9,0,-3,5,29,30,-1,5,0,-6,1
New York Rangers,2013/01/26  vs. TOR,TOR,1,53,29,24,3,9,12,11,42,20,22,4,7,11,11
Philadelphia Flyers,2013/02/09  vs. CAR,CAR,1,46,54,-8,-5,-2,-1,-7,36,35,1,-1,3,-1,-2
Philadelphia Flyers,2013/03/10  vs. BUF,BUF,1,33,30,3,7,-4,0,8,24,18,6,4,2,0,7
Carolina Hurricanes,2013/04/04  vs. TBL,TBL,1,78,48,30,14,0,16,18,60,39,21,10,0,11,10
Winnipeg Jets,2013/02/21  vs. CAR,CAR,1,46,46,0,2,-2,0,0,29,36,-7,-7,0,0,-7
Edmonton Oilers,2013/04/08  vs. ANA,ANA,1,38,50,-12,-3,0,-9,-12,33,34,-1,4,0,-5,-3
Buffalo Sabres,2013/02/10  vs. BOS,BOS,1,34,56,-22,-22,0,0,-23,27,40,-13,-9,0,-4,-12
Columbus Blue Jackets,2013/03/28  vs. EDM,EDM,1,52,42,10,-5,12,3,2,38,29,9,-1,7,3,2
Tampa Bay Lightning,2013/03/26  vs. BUF,BUF,1,26,34,-8,-5,-3,0,0,24,22,2,-2,4,0,5
New York Rangers,2013/01/19  vs. BOS,BOS,1,24,32,-8,-5,0,-3,-12,22,24,-2,-4,0,2,-5
Colorado Avalanche,2013/04/15  vs. CBJ,CBJ,1,53,55,-2,-1,1,-2,0,41,36,5,6,1,-2,7
Ottawa Senators,2013/03/08  vs. NYR,NYR,1,71,51,20,7,13,0,12,51,42,9,0,9,0,2
Toronto Maple Leafs,2013/02/04  vs. CAR,CAR,1,55,46,9,0,-4,13,1,43,38,5,1,-2,6,0
Toronto Maple Leafs,2013/03/25  vs. BOS,BOS,1,26,54,-28,-13,-15,0,-25,20,39,-19,-10,-9,0,-18
Detroit Red Wings,2013/03/03  vs. CHI,CHI,1,33,49,-16,-11,-5,0,-11,26,40,-14,-13,-1,0,-13
Chicago Blackhawks,2013/01/20  vs. PHX,PHX,1,48,42,6,1,1,4,5,35,35,0,-2,1,1,-1
Ottawa Senators,2013/04/28  vs. BOS,BOS,1,40,54,-14,-7,-7,0,-9,27,43,-16,-7,-9,0,-12
Anaheim Ducks,2013/03/18  vs. SJS,SJS,1,35,58,-23,-16,-7,0,-14,29,43,-14,-9,-5,0,-6
Columbus Blue Jackets,2013/02/23  vs. STL,STL,1,35,32,3,4,0,-1,2,19,26,-7,3,0,-10,-3
Detroit Red Wings,2013/02/19  vs. NSH,NSH,1,50,29,21,6,0,15,21,37,24,13,3,0,10,12
Tampa Bay Lightning,2013/04/09  vs. OTT,OTT,1,26,55,-29,-20,-7,-2,-26,21,41,-20,-14,-5,-1,-17
Minnesota Wild,2013/02/23  vs. CGY,CGY,1,46,41,5,-2,0,7,1,34,32,2,-5,0,7,0
New York Islanders,2013/01/24  vs. TOR,TOR,1,45,48,-3,1,2,-6,-5,39,35,4,2,7,-5,-3
Ottawa Senators,2013/02/18  vs. NJD,NJD,1,35,33,2,-1,0,3,3,33,27,6,0,0,6,5
Colorado Avalanche,2013/04/06  vs. PHX,PHX,1,35,49,-14,-4,0,-10,-8,26,41,-15,-2,0,-13,-9
Nashville Predators,2013/03/21  vs. CGY,CGY,1,32,43,-11,-1,-11,1,1,24,27,-3,1,-4,0,3
Toronto Maple Leafs,2013/02/18  vs. FLA,FLA,1,37,49,-12,-8,-4,0,-13,31,42,-11,-10,-1,0,-13
Tampa Bay Lightning,2013/04/16  vs. WPG,WPG,1,45,53,-8,8,0,-16,-5,32,41,-9,5,0,-14,-8
Minnesota Wild,2013/03/16  vs. COL,COL,1,45,40,5,-2,7,0,2,32,33,-1,-2,1,0,-1
Florida Panthers,2013/04/11  vs. WPG,WPG,1,44,47,-3,-4,0,1,-3,35,34,1,1,0,0,-1
New York Rangers,2013/03/30  vs. MTL,MTL,1,68,50,18,1,0,17,12,45,35,10,1,0,9,10
New York Rangers,2013/03/07  vs. NYI,NYI,1,70,51,19,2,0,17,16,53,33,20,0,0,20,17
Carolina Hurricanes,2013/02/01  vs. OTT,OTT,1,39,49,-10,4,-14,0,-3,32,36,-4,3,-7,0,-4
San Jose Sharks,2013/02/04  vs. ANA,ANA,1,42,39,3,2,3,-2,1,26,29,-3,-2,3,-4,-3
New Jersey Devils,2013/03/02  vs. BUF,BUF,1,39,29,10,10,1,-1,10,27,21,6,6,0,0,6
New York Rangers,2013/04/13  vs. NYI,NYI,1,29,57,-28,-28,0,0,-28,19,40,-21,-21,0,0,-21
Toronto Maple Leafs,2013/04/06  vs. NJD,NJD,1,27,41,-14,-2,-12,0,-9,21,31,-10,-1,-9,0,-5
Chicago Blackhawks,2013/01/27  vs. DET,DET,1,33,44,-11,-1,-10,0,-6,20,29,-9,-4,-5,0,-9
Florida Panthers,2013/04/02  vs. TBL,TBL,1,39,55,-16,-11,-5,0,-7,30,46,-16,-8,-8,0,-7
Dallas Stars,2013/03/16  vs. CHI,CHI,1,30,51,-21,-1,0,-20,-7,22,39,-17,1,0,-18,-4
Tampa Bay Lightning,2013/02/10  vs. NYR,NYR,1,31,54,-23,0,0,-23,-6,25,42,-17,0,0,-17,-4
Toronto Maple Leafs,2013/03/26  vs. FLA,FLA,1,46,71,-25,-13,-3,-9,-22,31,52,-21,-9,-1,-11,-20
Detroit Red Wings,2013/02/23  vs. NSH,NSH,1,35,54,-19,-3,-16,0,-8,29,45,-16,-2,-14,0,-10
Colorado Avalanche,2013/02/28  vs. CGY,CGY,1,47,38,9,2,0,7,4,33,26,7,2,1,4,4
Philadelphia Flyers,2013/02/12  vs. WPG,WPG,1,34,43,-9,-5,-4,0,-5,22,34,-12,-4,-8,0,-8
Detroit Red Wings,2013/01/19  vs. STL,STL,1,26,50,-24,-4,0,-20,-14,18,40,-22,-2,0,-20,-10
New York Islanders,2013/02/16  vs. NJD,NJD,1,37,44,-7,-3,-4,0,-2,30,29,1,-1,2,0,0
Phoenix Coyotes,2013/02/28  vs. MIN,MIN,1,50,33,17,4,0,13,13,38,22,16,3,0,13,9
Tampa Bay Lightning,2013/02/16  vs. FLA,FLA,1,49,41,8,-3,3,8,5,44,38,6,-3,1,8,3
New Jersey Devils,2013/02/09  vs. PIT,PIT,1,27,16,11,0,0,11,11,21,15,6,-1,0,7,6
St. Louis Blues,2013/03/23  vs. EDM,EDM,1,50,28,22,3,19,0,21,33,20,13,2,11,0,10
Edmonton Oilers,2013/03/01  vs. STL,STL,1,37,57,-20,-20,-1,1,-21,25,38,-13,-14,0,1,-15
Tampa Bay Lightning,2013/04/24  vs. TOR,TOR,1,50,50,0,-3,2,1,-3,35,39,-4,-6,0,2,-5
Chicago Blackhawks,2013/03/05  vs. MIN,MIN,1,51,32,19,2,9,8,12,37,27,10,3,2,5,10
Montreal Canadiens,2013/02/25  vs. OTT,OTT,1,53,35,18,19,0,-1,18,44,27,17,17,0,0,17
Pittsburgh Penguins,2013/02/20  vs. PHI,PHI,1,37,31,6,11,-6,1,12,30,23,7,10,-3,0,11
Vancouver Canucks,2013/04/27  vs. EDM,EDM,1,47,54,-7,3,-3,-7,0,41,48,-7,4,-4,-7,0
Dallas Stars,2013/03/20  vs. COL,COL,1,50,41,9,-4,14,-1,8,33,34,-1,-3,4,-2,1
Carolina Hurricanes,2013/02/12  vs. NJD,NJD,1,27,32,-5,-2,-4,1,1,19,27,-8,-4,-4,0,-2
Dallas Stars,2013/04/13  vs. SJS,SJS,1,31,62,-31,-2,-29,0,-4,21,42,-21,-1,-20,0,-1
Los Angeles Kings,2013/01/22  vs. COL,COL,1,39,37,2,11,-7,-2,9,27,31,-4,7,-8,-3,4
Tampa Bay Lightning,2013/02/12  vs. MTL,MTL,1,31,33,-2,3,0,-5,2,20,26,-6,6,0,-12,5
San Jose Sharks,2013/04/18  vs. MIN,MIN,1,52,59,-7,1,-8,0,10,40,41,-1,0,-1,0,8
St. Louis Blues,2013/02/13  vs. DET,DET,1,29,38,-9,-8,1,-2,-6,22,20,2,2,2,-2,4
Anaheim Ducks,2013/01/26  vs. NSH,NSH,1,45,31,14,1,0,13,15,31,22,9,3,0,6,10
Winnipeg Jets,2013/02/26  vs. NYR,NYR,1,39,48,-9,8,-17,0,12,29,34,-5,4,-9,0,7
Carolina Hurricanes,2013/03/28  vs. TOR,TOR,1,40,52,-12,-9,-5,2,-5,29,37,-8,-7,-3,2,-2
Montreal Canadiens,2013/02/14  vs. FLA,FLA,1,37,39,-2,-2,0,0,-2,31,30,1,1,0,0,1
New Jersey Devils,2013/03/13  vs. PHI,PHI,1,42,27,15,4,11,0,5,32,19,13,3,10,0,3
Winnipeg Jets,2013/03/16  vs. TOR,TOR,1,64,43,21,1,3,17,15,41,28,13,0,3,10,10
Carolina Hurricanes,2013/02/18  vs. MTL,MTL,1,35,37,-2,4,0,-6,4,28,26,2,6,0,-4,6
Carolina Hurricanes,2013/04/23  vs. NYI,NYI,1,52,68,-16,-6,-10,0,-6,38,56,-18,-6,-12,0,-8
Tampa Bay Lightning,2013/01/21  vs. NYI,NYI,1,32,43,-11,-9,0,-2,-14,26,36,-10,-8,0,-2,-13
New York Islanders,2013/01/31  vs. NJD,NJD,1,27,37,-10,-5,-5,0,-8,20,28,-8,-7,-1,0,-6
Minnesota Wild,2013/03/23  vs. SJS,SJS,1,31,43,-12,4,-16,0,2,20,31,-11,3,-14,0,3
Minnesota Wild,2013/02/12  vs. VAN,VAN,1,23,45,-22,-8,0,-14,-17,19,35,-16,-7,0,-9,-13
Toronto Maple Leafs,2013/03/12  vs. WPG,WPG,1,35,50,-15,1,0,-16,-8,27,33,-6,3,0,-9,0
Chicago Blackhawks,2013/03/20  vs. ANA,ANA,1,44,47,-3,-14,14,-3,-9,29,37,-8,-15,10,-3,-11
Montreal Canadiens,2013/03/19  vs. BUF,BUF,1,71,26,45,1,0,44,8,51,18,33,2,0,31,5
Dallas Stars,2013/04/07  vs. SJS,SJS,1,52,49,3,-4,0,7,-5,34,40,-6,-8,0,2,-11
New Jersey Devils,2013/04/06  vs. TOR,TOR,1,41,27,14,2,0,12,9,31,21,10,1,0,9,5
Ottawa Senators,2013/03/30  vs. TOR,TOR,1,44,32,12,-3,0,15,3,32,20,12,-2,0,14,4
New York Islanders,2013/04/11  vs. BOS,BOS,1,50,49,1,-4,5,0,3,43,34,9,-1,10,0,9
Montreal Canadiens,2013/02/07  vs. BUF,BUF,1,37,38,-1,-1,0,0,1,30,31,-1,-1,0,0,1
Florida Panthers,2013/01/21  vs. OTT,OTT,1,43,40,3,-3,0,6,-8,30,29,1,-3,0,4,-3
Carolina Hurricanes,2013/03/05  vs. BUF,BUF,1,54,55,-1,2,-3,0,25,35,44,-9,1,-10,0,15
Philadelphia Flyers,2013/02/11  vs. TOR,TOR,1,55,43,12,-2,-3,17,-6,42,30,12,-2,2,12,-1
Phoenix Coyotes,2013/03/21  vs. VAN,VAN,1,47,32,15,-2,0,17,11,32,28,4,-4,0,8,1
New Jersey Devils,2013/03/25  vs. OTT,OTT,1,58,26,32,12,0,20,29,44,18,26,9,0,17,23
New York Islanders,2013/03/03  vs. OTT,OTT,1,56,42,14,5,9,0,11,38,31,7,0,7,0,5
Phoenix Coyotes,2013/02/07  vs. CHI,CHI,1,40,42,-2,-4,0,2,-6,27,32,-5,-6,0,1,-6
Columbus Blue Jackets,2013/04/25  vs. DAL,DAL,1,38,64,-26,-5,-21,0,-15,33,41,-8,0,-8,0,-1
Philadelphia Flyers,2013/02/20  vs. PIT,PIT,1,31,37,-6,-11,-1,6,-12,23,30,-7,-10,0,3,-11
Florida Panthers,2013/02/16  vs. TBL,TBL,1,41,49,-8,3,-8,-3,-5,38,44,-6,3,-8,-1,-3
Edmonton Oilers,2013/02/21  vs. MIN,MIN,1,48,51,-3,0,1,-4,1,36,33,3,1,1,1,2
Carolina Hurricanes,2013/03/12  vs. WSH,WSH,1,53,43,10,4,6,0,11,34,33,1,1,0,0,3
Vancouver Canucks,2013/01/20  vs. EDM,EDM,1,40,39,1,0,1,0,-2,28,31,-3,-1,-2,0,-7
Florida Panthers,2013/02/03  vs. BUF,BUF,1,45,39,6,5,-1,2,9,34,28,6,5,-1,2,11
Colorado Avalanche,2013/03/16  vs. MIN,MIN,1,40,45,-5,2,0,-7,-2,33,32,1,2,0,-1,1
Colorado Avalanche,2013/03/12  vs. EDM,EDM,1,49,41,8,2,0,6,3,40,39,1,0,0,1,0
Anaheim Ducks,2013/04/03  vs. DAL,DAL,1,36,49,-13,6,-19,0,-7,30,34,-4,8,-12,0,-1
Philadelphia Flyers,2013/04/09  vs. NYI,NYI,1,48,56,-8,0,-3,-5,-8,36,40,-4,4,-1,-7,-1
Columbus Blue Jackets,2013/01/26  vs. CHI,CHI,1,27,27,0,-6,4,2,2,17,19,-2,-2,3,-3,2
Montreal Canadiens,2013/02/23  vs. NYR,NYR,1,46,50,-4,-8,4,0,-5,29,34,-5,-4,-1,0,-3
Carolina Hurricanes,2013/02/07  vs. OTT,OTT,1,36,63,-27,-17,0,-10,-31,26,45,-19,-9,0,-10,-21
Tampa Bay Lightning,2013/03/05  vs. NJD,NJD,1,25,39,-14,-7,-7,0,-13,20,31,-11,-7,-4,0,-12
Boston Bruins,2013/02/21  vs. TBL,TBL,1,41,44,-3,2,-5,0,-1,31,32,-1,-2,1,0,0
New York Islanders,2013/01/25  vs. BOS,BOS,1,29,50,-21,-10,2,-13,-16,20,33,-13,-4,2,-11,-10
Anaheim Ducks,2013/02/09  vs. STL,STL,1,39,51,-12,-18,-2,8,-22,25,34,-9,-12,-1,4,-14
Edmonton Oilers,2013/01/31  vs. SJS,SJS,1,36,46,-10,-6,0,-4,-10,26,32,-6,-2,0,-4,-5
Winnipeg Jets,2013/02/17  vs. BOS,BOS,1,62,59,3,2,-3,4,-1,43,41,2,-2,-4,8,-6
Detroit Red Wings,2013/03/10  vs. CBJ,CBJ,1,26,34,-8,-7,0,-1,-8,21,23,-2,-4,0,2,-2
San Jose Sharks,2013/03/23  vs. MIN,MIN,1,43,31,12,-4,0,16,-2,31,20,11,-3,0,14,-3
Washington Capitals,2013/04/25  vs. OTT,OTT,1,31,45,-14,-3,0,-11,-6,23,36,-13,-2,0,-11,-6
Anaheim Ducks,2013/02/27  vs. NSH,NSH,1,41,35,6,3,3,0,3,31,24,7,2,5,0,3
Washington Capitals,2013/02/23  vs. NJD,NJD,1,32,35,-3,1,-4,0,-3,25,25,0,4,-4,0,2
Dallas Stars,2013/03/14  vs. ANA,ANA,1,53,44,9,2,7,0,9,38,27,11,7,4,0,11
Calgary Flames,2013/04/01  vs. EDM,EDM,1,59,44,15,4,0,11,14,48,29,19,3,0,16,10
Carolina Hurricanes,2013/04/02  vs. WSH,WSH,1,48,29,19,3,1,15,12,35,20,15,5,1,9,14
Boston Bruins,2013/03/21  vs. OTT,OTT,1,52,54,-2,-5,1,2,-3,39,37,2,2,1,-1,1
Philadelphia Flyers,2013/04/27  vs. OTT,OTT,1,41,56,-15,-4,-11,0,-12,32,44,-12,-4,-8,0,-10
Florida Panthers,2013/04/16  vs. NYI,NYI,1,51,41,10,-9,0,19,-12,33,35,-2,-6,0,4,-9
Colorado Avalanche,2013/04/13  vs. VAN,VAN,1,44,43,1,0,-6,7,-2,34,30,4,0,-1,5,0
Colorado Avalanche,2013/02/14  vs. MIN,MIN,1,45,46,-1,-6,4,1,-2,38,30,8,2,6,0,8
Montreal Canadiens,2013/02/03  vs. OTT,OTT,1,43,57,-14,4,-18,0,6,34,36,-2,1,-3,0,4
Pittsburgh Penguins,2013/02/09  vs. NJD,NJD,1,16,27,-11,0,-11,0,-11,15,21,-6,1,-7,0,-6
Boston Bruins,2013/03/30  vs. PHI,PHI,1,60,35,25,6,0,19,7,45,23,22,7,0,15,8
Los Angeles Kings,2013/01/28  vs. VAN,VAN,1,47,25,22,3,0,19,6,32,20,12,0,0,12,1
Edmonton Oilers,2013/03/25  vs. NSH,NSH,1,34,38,-4,-6,-1,3,-4,25,26,-1,-1,-1,1,-2
New Jersey Devils,2013/02/02  vs. PIT,PIT,1,33,49,-16,-2,0,-14,-8,20,37,-17,-4,0,-13,-10
Dallas Stars,2013/02/01  vs. PHX,PHX,1,37,43,-6,-3,-3,0,-7,25,32,-7,-5,-2,0,-9
Winnipeg Jets,2013/02/12  vs. PHI,PHI,1,43,34,9,5,0,4,5,34,22,12,4,0,8,8
Los Angeles Kings,2013/03/09  vs. CGY,CGY,1,51,36,15,4,11,0,9,37,28,9,3,6,0,5
Edmonton Oilers,2013/02/04  vs. VAN,VAN,1,39,50,-11,-1,-10,0,-9,24,32,-8,0,-8,0,-4
Columbus Blue Jackets,2013/02/24  vs. CHI,CHI,1,23,41,-18,-8,0,-10,-12,16,32,-16,-5,0,-11,-9
Chicago Blackhawks,2013/04/04  vs. STL,STL,1,45,33,12,0,4,8,13,39,24,15,5,5,5,17
New Jersey Devils,2013/01/22  vs. PHI,PHI,1,24,33,-9,0,-9,0,-8,19,22,-3,0,-3,0,-6
Pittsburgh Penguins,2013/04/09  vs. CAR,CAR,1,60,52,8,2,9,-3,5,46,36,10,3,10,-3,5
Calgary Flames,2013/02/07  vs. CBJ,CBJ,1,45,26,19,10,1,8,19,32,21,11,3,1,7,11
St. Louis Blues,2013/04/09  vs. NSH,NSH,1,51,29,22,18,4,0,21,35,20,15,15,0,0,17
Washington Capitals,2013/04/13  vs. TBL,TBL,1,39,54,-15,-3,-12,0,5,32,37,-5,0,-5,0,8
Winnipeg Jets,2013/04/23  vs. WSH,WSH,1,38,67,-29,-4,0,-25,-24,23,51,-28,-3,0,-25,-21
Vancouver Canucks,2013/03/19  vs. STL,STL,1,39,49,-10,0,-10,0,2,28,36,-8,-4,-4,0,-2
San Jose Sharks,2013/02/09  vs. PHX,PHX,1,53,38,15,15,0,0,15,37,29,8,8,0,0,8
Chicago Blackhawks,2013/04/19  vs. NSH,NSH,1,50,31,19,17,1,1,16,38,26,12,9,1,2,10
Detroit Red Wings,2013/02/17  vs. MIN,MIN,1,47,38,9,-1,7,3,8,37,32,5,-1,4,2,4
Los Angeles Kings,2013/03/19  vs. PHX,PHX,1,34,58,-24,-6,-18,0,-4,30,45,-15,-6,-9,0,-2
St. Louis Blues,2013/04/16  vs. VAN,VAN,1,54,33,21,16,0,5,16,41,24,17,14,0,3,14
Philadelphia Flyers,2013/03/02  vs. OTT,OTT,1,46,44,2,11,-9,0,12,30,34,-4,4,-8,0,6
Philadelphia Flyers,2013/04/11  vs. OTT,OTT,1,33,56,-23,-14,0,-9,-24,18,42,-24,-16,0,-8,-24
Phoenix Coyotes,2013/03/19  vs. LAK,LAK,1,58,34,24,6,0,18,4,45,30,15,6,0,9,2
New York Islanders,2013/04/20  vs. WPG,WPG,1,52,44,8,5,3,0,14,37,32,5,2,3,0,9
Phoenix Coyotes,2013/02/16  vs. CBJ,CBJ,1,32,41,-9,2,-11,0,-4,24,23,1,5,-3,-1,1
Ottawa Senators,2013/02/21  vs. NYR,NYR,1,47,46,1,-1,-1,3,8,35,34,1,-2,0,3,3
Colorado Avalanche,2013/04/05  vs. DET,DET,1,54,45,9,2,0,7,3,33,29,4,4,0,0,0
Buffalo Sabres,2013/01/31  vs. BOS,BOS,1,41,61,-20,-17,-1,-2,-18,35,41,-6,-5,-1,0,-6
Colorado Avalanche,2013/03/05  vs. DET,DET,1,49,44,5,10,0,-5,9,38,36,2,3,0,-1,1
Edmonton Oilers,2013/02/19  vs. LAK,LAK,1,34,62,-28,-21,0,-7,-27,27,47,-20,-15,0,-5,-19
Tampa Bay Lightning,2013/02/21  vs. BOS,BOS,1,44,41,3,-2,0,5,1,32,31,1,2,0,-1,0
Edmonton Oilers,2013/03/07  vs. DET,DET,1,39,57,-18,-3,0,-15,-10,26,39,-13,-4,0,-9,-8
Columbus Blue Jackets,2013/03/03  vs. COL,COL,1,40,30,10,12,0,-2,12,28,22,6,8,0,-2,8
Detroit Red Wings,2013/02/13  vs. STL,STL,1,38,29,9,8,2,-1,6,20,22,-2,-2,2,-2,-4
Washington Capitals,2013/04/23  vs. WPG,WPG,1,67,38,29,4,25,0,24,51,23,28,3,25,0,21
Anaheim Ducks,2013/04/21  vs. EDM,EDM,1,43,37,6,7,0,-1,9,34,28,6,9,0,-3,9
New Jersey Devils,2013/01/25  vs. WSH,WSH,1,29,27,2,-6,8,0,6,20,26,-6,-7,1,0,-2
New Jersey Devils,2013/02/24  vs. WPG,WPG,1,39,39,0,1,1,-2,-1,30,31,-1,0,0,-1,0
Los Angeles Kings,2013/04/09  vs. DAL,DAL,1,48,44,4,1,-1,4,0,36,33,3,2,0,1,2
Minnesota Wild,2013/02/14  vs. COL,COL,1,46,45,1,6,-1,-4,2,30,38,-8,-2,0,-6,-8
Los Angeles Kings,2013/03/21  vs. DAL,DAL,1,49,37,12,13,0,-1,13,43,27,16,17,0,-1,17
St. Louis Blues,2013/04/11  vs. MIN,MIN,1,33,37,-4,-4,0,0,2,21,25,-4,-4,0,0,-2
Columbus Blue Jackets,2013/02/10  vs. EDM,EDM,1,35,18,17,9,0,8,13,25,14,11,4,0,7,6
Buffalo Sabres,2013/02/09  vs. NYI,NYI,1,34,68,-34,-16,-18,0,-34,20,50,-30,-18,-12,0,-28
Winnipeg Jets,2013/01/29  vs. MTL,MTL,1,24,33,-9,-12,-1,4,-11,12,27,-15,-11,-1,-3,-16
Pittsburgh Penguins,2013/02/10  vs. NJD,NJD,1,40,44,-4,11,0,-15,1,29,29,0,9,0,-9,2
Columbus Blue Jackets,2013/03/26  vs. VAN,VAN,1,32,59,-27,-27,0,0,-27,17,36,-19,-19,0,0,-19
Winnipeg Jets,2013/04/20  vs. NYI,NYI,1,44,52,-8,-5,0,-3,-14,32,37,-5,-2,0,-3,-9
Buffalo Sabres,2013/02/12  vs. OTT,OTT,1,41,35,6,10,0,-4,8,35,26,9,12,0,-3,11
Dallas Stars,2013/01/28  vs. CBJ,CBJ,1,33,28,5,4,-4,5,0,26,20,6,6,-4,4,2
Toronto Maple Leafs,2013/04/13  vs. MTL,MTL,1,35,61,-26,-2,-24,0,-9,27,47,-20,0,-20,0,-8
Carolina Hurricanes,2013/01/25  vs. BUF,BUF,1,44,40,4,7,-2,-1,7,41,33,8,9,0,-1,9
New York Islanders,2013/04/26  vs. BUF,BUF,1,34,47,-13,-3,0,-10,-5,29,32,-3,1,0,-4,2
Pittsburgh Penguins,2013/04/02  vs. BUF,BUF,1,34,35,-1,0,0,-1,-2,19,23,-4,1,0,-5,-3
Columbus Blue Jackets,2013/02/02  vs. DET,DET,1,26,43,-17,-4,-10,-3,-14,22,34,-12,-4,-5,-3,-13
Los Angeles Kings,2013/01/26  vs. PHX,PHX,1,44,38,6,2,4,0,9,37,31,6,-1,7,0,6
Anaheim Ducks,2013/02/08  vs. DAL,DAL,1,33,38,-5,-12,0,7,-12,25,26,-1,-9,0,8,-5
Vancouver Canucks,2013/04/06  vs. CGY,CGY,1,33,52,-19,0,-19,0,-8,24,40,-16,0,-16,0,-8
Columbus Blue Jackets,2013/03/05  vs. EDM,EDM,1,45,41,4,3,2,-1,4,35,30,5,3,3,-1,5
Philadelphia Flyers,2013/03/07  vs. PIT,PIT,1,38,41,-3,3,-10,4,0,28,26,2,4,-3,1,5
Tampa Bay Lightning,2013/01/29  vs. FLA,FLA,1,32,37,-5,-4,-1,0,-1,29,27,2,-3,5,0,0
Pittsburgh Penguins,2013/04/22  vs. OTT,OTT,1,14,38,-24,-5,-19,0,-9,12,27,-15,-4,-11,0,-6
Florida Panthers,2013/02/07  vs. PHI,PHI,1,37,38,-1,-4,1,2,-6,27,23,4,-3,1,6,1
Toronto Maple Leafs,2013/02/27  vs. MTL,MTL,1,50,60,-10,-14,2,2,-12,35,43,-8,-11,2,1,-8
Tampa Bay Lightning,2013/02/05  vs. PHI,PHI,1,42,49,-7,-2,0,-5,-12,29,31,-2,1,0,-3,-4
Anaheim Ducks,2013/01/19  vs. VAN,VAN,1,35,49,-14,1,-12,-3,-2,29,35,-6,1,-5,-2,-3
St. Louis Blues,2013/03/12  vs. SJS,SJS,1,28,65,-37,-2,-35,0,-29,21,47,-26,-6,-20,0,-20
Detroit Red Wings,2013/01/22  vs. DAL,DAL,1,44,37,7,3,0,4,0,36,27,9,2,0,7,1
Edmonton Oilers,2013/03/20  vs. SJS,SJS,1,37,54,-17,-20,3,0,-19,28,41,-13,-16,3,0,-14
Columbus Blue Jackets,2013/02/21  vs. DET,DET,1,39,32,7,-4,1,10,10,27,24,3,-2,1,4,5
Anaheim Ducks,2013/03/20  vs. CHI,CHI,1,47,44,3,14,3,-14,9,37,29,8,15,3,-10,11
Toronto Maple Leafs,2013/02/07  vs. WPG,WPG,1,33,39,-6,-10,0,4,-13,17,32,-15,-12,-1,-2,-14
Carolina Hurricanes,2013/02/04  vs. TOR,TOR,1,46,55,-9,0,-13,4,-1,38,43,-5,-1,-6,2,0
Pittsburgh Penguins,2013/01/20  vs. NYR,NYR,1,50,45,5,-5,10,0,-2,40,35,5,-4,9,0,1
New York Rangers,2013/03/26  vs. PHI,PHI,1,57,55,2,6,-4,0,9,40,36,4,2,2,0,7
Nashville Predators,2013/02/12  vs. SJS,SJS,1,34,37,-3,-3,0,0,-3,24,25,-1,-1,0,0,-1
Florida Panthers,2013/01/31  vs. WPG,WPG,1,40,39,1,10,-6,-3,9,28,36,-8,1,-6,-3,-2
Montreal Canadiens,2013/02/12  vs. TBL,TBL,1,33,31,2,-3,5,0,-2,26,20,6,-6,12,0,-5
Buffalo Sabres,2013/02/05  vs. OTT,OTT,1,33,51,-18,-7,0,-11,-10,24,32,-8,-3,0,-5,-4
Carolina Hurricanes,2013/01/19  vs. FLA,FLA,1,59,23,36,4,0,32,6,49,16,33,3,0,30,5
Boston Bruins,2013/03/17  vs. PIT,PIT,1,56,39,17,-1,0,18,2,42,30,12,1,0,11,0
Colorado Avalanche,2013/03/27  vs. CGY,CGY,1,42,37,5,1,0,4,-7,31,27,4,1,0,3,0
Vancouver Canucks,2013/02/22  vs. NSH,NSH,1,53,33,20,24,-4,0,24,39,22,17,18,-1,0,18
Dallas Stars,2013/04/15  vs. CHI,CHI,1,27,43,-16,-11,0,-5,-16,18,30,-12,-5,0,-7,-13
Buffalo Sabres,2013/03/02  vs. NJD,NJD,1,29,39,-10,-10,1,-1,-10,21,27,-6,-6,0,0,-6
Vancouver Canucks,2013/01/27  vs. SJS,SJS,1,36,18,18,0,0,18,3,25,12,13,0,0,13,3
Washington Capitals,2013/02/17  vs. NYR,NYR,1,32,52,-20,1,-20,-1,-19,25,39,-14,4,-18,0,-14
Winnipeg Jets,2013/02/28  vs. NJD,NJD,1,34,47,-13,-10,-3,0,-9,23,30,-7,-5,-2,0,-3
Washington Capitals,2013/02/01  vs. PHI,PHI,1,34,51,-17,-4,-6,-7,-11,25,33,-8,-4,0,-4,-8
Columbus Blue Jackets,2013/03/01  vs. CHI,CHI,1,45,58,-13,-12,4,-5,-10,31,43,-12,-7,1,-6,-8
Nashville Predators,2013/01/24  vs. STL,STL,1,25,27,-2,-4,0,2,-8,16,19,-3,-4,0,1,-7
Tampa Bay Lightning,2013/04/25  vs. BOS,BOS,1,41,40,1,2,0,-1,-1,29,29,0,2,0,-2,-2
New York Rangers,2013/04/08  vs. TOR,TOR,1,62,49,13,0,0,13,9,46,33,13,1,0,12,9
Minnesota Wild,2013/04/11  vs. STL,STL,1,37,33,4,4,0,0,-2,25,21,4,4,0,0,2
Florida Panthers,2013/03/21  vs. NYR,NYR,1,35,68,-33,-2,-31,0,-6,29,47,-18,1,-19,0,-3
Edmonton Oilers,2013/02/23  vs. PHX,PHX,1,50,45,5,1,0,4,6,38,38,0,1,0,-1,1
Montreal Canadiens,2013/01/24  vs. WSH,WSH,1,24,47,-23,-8,-15,0,-9,18,34,-16,-6,-10,0,-7
Detroit Red Wings,2013/02/01  vs. STL,STL,1,33,30,3,2,2,-1,3,23,21,2,3,2,-3,2
Pittsburgh Penguins,2013/04/11  vs. TBL,TBL,1,38,36,2,-5,7,0,3,30,26,4,-4,8,0,3
Washington Capitals,2013/03/19  vs. PIT,PIT,1,48,45,3,1,1,1,2,30,35,-5,-2,1,-4,-1
Chicago Blackhawks,2013/04/22  vs. VAN,VAN,1,37,40,-3,-9,0,6,-4,26,29,-3,-5,0,2,-4
Florida Panthers,2013/01/24  vs. OTT,OTT,1,35,51,-16,-14,0,-2,-8,24,33,-9,-8,0,-1,-4
Ottawa Senators,2013/04/02  vs. BOS,BOS,1,61,62,-1,-2,0,1,-3,45,55,-10,-4,0,-6,-11
Dallas Stars,2013/04/23  vs. SJS,SJS,1,54,66,-12,-1,-14,3,-10,34,43,-9,0,-8,-1,-9
Montreal Canadiens,2013/04/25  vs. WPG,WPG,1,57,42,15,0,2,13,14,40,32,8,0,0,8,9
Ottawa Senators,2013/03/13  vs. MTL,MTL,1,41,59,-18,-21,0,3,-16,23,41,-18,-20,0,2,-16
Toronto Maple Leafs,2013/02/05  vs. WSH,WSH,1,35,56,-21,-2,-19,0,-13,27,36,-9,-2,-7,0,-7
New Jersey Devils,2013/02/10  vs. PIT,PIT,1,44,40,4,-11,15,0,-1,29,29,0,-9,9,0,-2
Los Angeles Kings,2013/03/05  vs. STL,STL,1,38,21,17,11,5,1,8,28,16,12,4,5,3,2
Winnipeg Jets,2013/03/12  vs. TOR,TOR,1,50,35,15,-1,16,0,8,33,27,6,-3,9,0,0
Edmonton Oilers,2013/03/03  vs. MIN,MIN,1,38,49,-11,-13,0,2,-12,26,43,-17,-15,0,-2,-17
St. Louis Blues,2013/03/03  vs. DAL,DAL,1,52,51,1,1,3,-3,-5,36,39,-3,0,4,-7,0
New York Rangers,2013/01/20  vs. PIT,PIT,1,45,50,-5,5,0,-10,2,35,40,-5,4,0,-9,-1
Calgary Flames,2013/04/26  vs. CHI,CHI,1,35,68,-33,-3,0,-30,-6,27,48,-21,-2,0,-19,-3
Nashville Predators,2013/01/21  vs. STL,STL,1,26,44,-18,-10,-8,0,-10,21,36,-15,-9,-6,0,-10
Dallas Stars,2013/03/23  vs. COL,COL,1,40,61,-21,0,-21,0,-2,28,41,-13,0,-13,0,-2
Detroit Red Wings,2013/01/27  vs. CHI,CHI,1,44,33,11,1,0,10,6,29,20,9,4,0,5,9
Phoenix Coyotes,2013/03/28  vs. NSH,NSH,1,40,47,-7,0,-7,0,3,34,42,-8,-1,-7,0,2
Vancouver Canucks,2013/01/30  vs. COL,COL,1,48,32,16,-5,21,0,10,29,26,3,-6,9,0,5
Columbus Blue Jackets,2013/03/31  vs. ANA,ANA,1,26,50,-24,-21,-3,0,-22,20,37,-17,-16,-1,0,-15
St. Louis Blues,2013/03/01  vs. EDM,EDM,1,57,37,20,20,-1,1,21,38,25,13,14,-1,0,15
Columbus Blue Jackets,2013/02/15  vs. LAK,LAK,1,19,31,-12,-10,0,-2,-10,14,26,-12,-11,0,-1,-11
Montreal Canadiens,2013/04/15  vs. PHI,PHI,1,34,24,10,1,0,9,-1,27,21,6,-1,0,7,-3
Anaheim Ducks,2013/04/10  vs. COL,COL,1,36,44,-8,-1,0,-7,-3,23,30,-7,0,0,-7,0
Edmonton Oilers,2013/03/26  vs. STL,STL,1,33,54,-21,-5,-16,0,-11,24,46,-22,-4,-18,0,-8
Philadelphia Flyers,2013/02/25  vs. TOR,TOR,1,40,39,1,4,0,-3,3,32,27,5,7,0,-2,5
New York Islanders,2013/01/21  vs. TBL,TBL,1,43,32,11,9,2,0,14,36,26,10,8,2,0,13
Detroit Red Wings,2013/04/20  vs. VAN,VAN,1,41,22,19,15,0,4,19,32,13,19,17,0,2,19
New York Rangers,2013/03/08  vs. OTT,OTT,1,51,71,-20,-7,0,-13,-12,42,51,-9,0,0,-9,-2
Dallas Stars,2013/03/09  vs. PHX,PHX,1,43,42,1,-5,0,6,1,23,32,-9,-6,0,-3,-7
Detroit Red Wings,2013/01/29  vs. DAL,DAL,1,32,32,0,-5,3,2,-3,27,25,2,0,1,1,1
Anaheim Ducks,2013/02/15  vs. DET,DET,1,45,47,-2,-2,0,0,-2,34,38,-4,-4,1,-1,-5
New Jersey Devils,2013/04/07  vs. BUF,BUF,1,44,29,15,0,0,15,12,29,19,10,-1,0,11,8
Minnesota Wild,2013/04/04  vs. LAK,LAK,1,38,32,6,-1,0,7,-2,29,24,5,0,0,5,-1
Colorado Avalanche,2013/04/11  vs. LAK,LAK,1,40,44,-4,-7,0,3,-8,33,35,-2,-8,0,6,-9
Calgary Flames,2013/03/11  vs. LAK,LAK,1,40,37,3,5,0,-2,3,29,30,-1,6,0,-7,4
New York Rangers,2013/03/28  vs. OTT,OTT,1,44,45,-1,-9,0,8,-8,28,29,-1,-7,0,6,-5
St. Louis Blues,2013/02/07  vs. DET,DET,1,45,41,4,0,0,4,-6,34,34,0,-2,0,2,-6
Phoenix Coyotes,2013/02/01  vs. DAL,DAL,1,43,37,6,3,0,3,7,32,25,7,5,0,2,9
St. Louis Blues,2013/03/16  vs. ANA,ANA,1,38,42,-4,-8,0,4,-4,28,26,2,-2,0,4,2
Calgary Flames,2013/03/03  vs. VAN,VAN,1,47,46,1,1,2,-2,-1,35,33,2,5,0,-3,2
Ottawa Senators,2013/02/12  vs. BUF,BUF,1,35,41,-6,-10,4,0,-8,26,35,-9,-12,3,0,-11
Nashville Predators,2013/04/15  vs. VAN,VAN,1,54,30,24,2,0,22,15,44,25,19,0,0,19,13
New York Rangers,2013/02/10  vs. TBL,TBL,1,54,31,23,0,23,0,6,42,25,17,0,17,0,4
Carolina Hurricanes,2013/03/30  vs. WPG,WPG,1,38,43,-5,2,-7,0,-7,29,31,-2,1,-3,0,-5
San Jose Sharks,2013/02/22  vs. CHI,CHI,1,38,46,-8,-5,0,-3,-5,25,34,-9,-2,0,-7,-2
Winnipeg Jets,2013/03/02  vs. WSH,WSH,1,43,41,2,1,0,1,1,31,33,-2,2,0,-4,0
New York Islanders,2013/03/30  vs. PIT,PIT,1,40,42,-2,-2,0,0,-2,29,32,-3,-3,0,0,-3
Carolina Hurricanes,2013/02/14  vs. TOR,TOR,1,58,33,25,16,9,0,17,41,24,17,10,7,0,11
Anaheim Ducks,2013/04/19  vs. CGY,CGY,1,61,42,19,3,0,16,4,41,29,12,2,0,10,1
New Jersey Devils,2013/03/21  vs. CAR,CAR,1,40,45,-5,-1,-4,0,5,25,32,-7,-2,-5,0,-8
Phoenix Coyotes,2013/03/16  vs. CBJ,CBJ,1,61,39,22,22,0,0,22,42,28,14,14,0,0,14
Phoenix Coyotes,2013/03/02  vs. ANA,ANA,1,73,39,34,30,1,3,31,48,28,20,16,1,3,17
Colorado Avalanche,2013/02/11  vs. PHX,PHX,1,51,37,14,7,3,4,18,45,28,17,8,6,3,18
St. Louis Blues,2013/02/23  vs. CBJ,CBJ,1,32,35,-3,-4,1,0,-2,26,19,7,-3,10,0,3
Carolina Hurricanes,2013/03/19  vs. FLA,FLA,1,61,57,4,-3,0,7,-3,45,47,-2,-7,0,5,-7
Colorado Avalanche,2013/02/16  vs. EDM,EDM,1,43,67,-24,0,-24,0,-15,35,53,-18,0,-17,-1,-9
Tampa Bay Lightning,2013/02/24  vs. PIT,PIT,1,46,36,10,2,0,8,4,31,24,7,2,0,5,6
Florida Panthers,2013/03/26  vs. TOR,TOR,1,71,46,25,13,9,3,22,52,31,21,9,11,1,20
Minnesota Wild,2013/04/03  vs. SJS,SJS,1,53,42,11,3,0,8,6,33,33,0,0,0,0,0
Colorado Avalanche,2013/04/27  vs. MIN,MIN,1,49,36,13,7,0,6,-2,37,31,6,5,0,1,-6
Philadelphia Flyers,2013/04/16  vs. NYR,NYR,1,36,52,-16,-2,-14,0,-4,22,40,-18,2,-20,0,-1
New York Islanders,2013/04/23  vs. CAR,CAR,1,68,52,16,6,0,10,6,56,38,18,6,0,12,8
Winnipeg Jets,2013/02/15  vs. PIT,PIT,1,51,52,-1,-2,0,1,-2,39,39,0,-3,0,3,0
Boston Bruins,2013/02/26  vs. NYI,NYI,1,44,50,-6,5,-11,0,7,33,38,-5,3,-8,0,3
New Jersey Devils,2013/01/31  vs. NYI,NYI,1,37,27,10,5,0,5,8,28,20,8,7,0,1,6
Nashville Predators,2013/03/04  vs. LAK,LAK,1,29,42,-13,-5,0,-8,-8,24,30,-6,-3,0,-3,-3
Nashville Predators,2013/02/22  vs. VAN,VAN,1,33,53,-20,-24,0,4,-24,22,39,-17,-18,0,1,-18
Boston Bruins,2013/04/11  vs. NYI,NYI,1,49,50,-1,4,0,-5,-3,34,43,-9,1,0,-10,-9
Carolina Hurricanes,2013/02/24  vs. NYI,NYI,1,50,47,3,5,0,-2,10,34,33,1,5,1,-5,8
Ottawa Senators,2013/02/23  vs. TOR,TOR,1,64,50,14,5,3,6,12,42,34,8,4,1,3,8
St. Louis Blues,2013/04/25  vs. CGY,CGY,1,36,27,9,5,4,0,4,25,20,5,2,3,0,2
Toronto Maple Leafs,2013/03/06  vs. OTT,OTT,1,49,81,-32,-9,-23,0,-10,37,59,-22,-6,-16,0,-6
Anaheim Ducks,2013/04/07  vs. LAK,LAK,1,25,61,-36,-15,-21,0,-18,21,39,-18,-10,-8,0,-8
Boston Bruins,2013/02/06  vs. MTL,MTL,1,37,40,-3,0,-7,4,4,27,21,6,-2,1,7,5
Buffalo Sabres,2013/03/05  vs. CAR,CAR,1,55,54,1,-2,0,3,-25,44,35,9,-1,0,10,-15
Vancouver Canucks,2013/04/04  vs. EDM,EDM,1,36,34,2,6,-4,0,10,32,25,7,7,0,0,12
Tampa Bay Lightning,2013/02/26  vs. BUF,BUF,1,38,34,4,-3,3,4,0,31,27,4,0,1,3,1
Philadelphia Flyers,2013/04/23  vs. BOS,BOS,1,44,61,-17,-4,-13,0,-5,34,43,-9,-3,-6,0,-3
San Jose Sharks,2013/04/24  vs. PHX,PHX,1,55,43,12,-3,0,15,4,39,32,7,1,0,6,3
Columbus Blue Jackets,2013/03/12  vs. VAN,VAN,1,39,60,-21,-17,-4,0,-21,32,36,-4,-1,-3,0,-4
Toronto Maple Leafs,2013/03/09  vs. PIT,PIT,1,40,60,-20,-5,0,-15,-23,27,45,-18,-2,0,-16,-14
Columbus Blue Jackets,2013/03/10  vs. DET,DET,1,34,26,8,7,1,0,8,23,21,2,4,-2,0,2
Nashville Predators,2013/04/01  vs. CHI,CHI,1,40,47,-7,-8,0,1,-20,30,32,-2,-4,0,2,-10
Montreal Canadiens,2013/04/01  vs. CAR,CAR,1,44,44,0,6,-3,-3,0,33,30,3,3,1,-1,1
Los Angeles Kings,2013/04/02  vs. PHX,PHX,1,51,49,2,7,0,-5,5,43,41,2,8,0,-6,6
Washington Capitals,2013/03/26  vs. NYI,NYI,1,56,36,20,12,0,8,15,36,27,9,9,0,0,8
Nashville Predators,2013/02/27  vs. ANA,ANA,1,35,41,-6,-3,0,-3,-3,24,31,-7,-2,0,-5,-3
Nashville Predators,2013/02/18  vs. COL,COL,1,57,37,20,-2,0,22,-2,38,29,9,-1,0,10,0
Edmonton Oilers,2013/04/21  vs. ANA,ANA,1,37,43,-6,-7,1,0,-9,28,34,-6,-9,3,0,-9
Vancouver Canucks,2013/04/25  vs. ANA,ANA,1,47,41,6,-4,0,10,-4,34,28,6,-4,0,10,-4
Carolina Hurricanes,2013/04/21  vs. TBL,TBL,1,35,52,-17,0,-17,0,-4,31,44,-13,0,-13,0,-1
Pittsburgh Penguins,2013/03/26  vs. MTL,MTL,1,35,60,-25,-14,-11,0,-18,23,44,-21,-12,-9,0,-16
Winnipeg Jets,2013/04/18  vs. CAR,CAR,1,41,47,-6,1,-7,0,-3,29,27,2,5,-3,0,4
Dallas Stars,2013/02/21  vs. VAN,VAN,1,41,32,9,5,3,1,8,27,24,3,3,1,-1,4
Edmonton Oilers,2013/01/26  vs. CGY,CGY,1,26,35,-9,3,0,-12,2,20,28,-8,3,0,-11,5
New York Islanders,2013/04/04  vs. WSH,WSH,1,47,42,5,-7,0,12,0,33,26,7,-2,0,9,2
Colorado Avalanche,2013/02/23  vs. LAK,LAK,1,30,42,-12,0,0,-12,-2,27,32,-5,0,0,-5,-1
Calgary Flames,2013/04/03  vs. EDM,EDM,1,40,45,-5,-11,2,4,-9,30,36,-6,-8,-1,3,-9
New York Rangers,2013/04/19  vs. BUF,BUF,1,43,45,-2,7,-9,0,6,33,30,3,3,0,0,3
Edmonton Oilers,2013/03/30  vs. VAN,VAN,1,43,39,4,0,4,0,1,35,26,9,0,9,0,1
Montreal Canadiens,2013/04/23  vs. NJD,NJD,1,22,30,-8,1,0,-9,1,18,23,-5,2,0,-7,2
New York Islanders,2013/03/24  vs. FLA,FLA,1,44,48,-4,0,-4,0,-6,35,32,3,1,2,0,-3
Edmonton Oilers,2013/04/16  vs. MIN,MIN,1,35,37,-2,-2,0,0,-1,23,28,-5,-3,0,-2,-1
Colorado Avalanche,2013/04/19  vs. EDM,EDM,1,53,40,13,0,0,13,8,32,29,3,0,0,3,4
Phoenix Coyotes,2013/04/18  vs. STL,STL,1,46,45,1,-1,0,2,0,34,35,-1,2,0,-3,1
Colorado Avalanche,2013/03/30  vs. NSH,NSH,1,51,42,9,9,0,0,9,34,32,2,2,0,0,2
Anaheim Ducks,2013/02/18  vs. CBJ,CBJ,1,41,58,-17,-5,-11,-1,-8,33,33,0,-2,0,2,5
Minnesota Wild,2013/04/15  vs. CGY,CGY,1,46,28,18,1,17,0,5,32,25,7,0,7,0,0
Vancouver Canucks,2013/02/21  vs. DAL,DAL,1,32,41,-9,-5,-1,-3,-8,24,27,-3,-3,1,-1,-4
Philadelphia Flyers,2013/03/24  vs. PIT,PIT,1,49,57,-8,-2,-6,0,-4,36,42,-6,-5,-1,0,-6
Phoenix Coyotes,2013/02/14  vs. NSH,NSH,1,39,49,-10,-7,0,-3,-7,24,34,-10,-10,0,0,-10
Dallas Stars,2013/02/17  vs. CGY,CGY,1,46,39,7,2,0,5,2,34,30,4,2,2,0,1
Detroit Red Wings,2013/02/10  vs. LAK,LAK,1,32,53,-21,-4,-17,0,-17,27,46,-19,-4,-15,0,-16
Philadelphia Flyers,2013/01/24  vs. NYR,NYR,1,52,36,16,2,14,0,5,40,20,20,6,14,0,8
Carolina Hurricanes,2013/04/09  vs. PIT,PIT,1,52,60,-8,-2,3,-9,-5,36,46,-10,-3,3,-10,-5
Colorado Avalanche,2013/04/26  vs. PHX,PHX,1,34,41,-7,-2,-6,1,-4,23,32,-9,-1,-8,0,-6
New York Islanders,2013/04/13  vs. NYR,NYR,1,57,29,28,28,0,0,28,40,19,21,21,0,0,21
Columbus Blue Jackets,2013/01/31  vs. STL,STL,1,33,26,7,1,0,6,-6,24,26,-2,1,0,-3,-6
Detroit Red Wings,2013/03/20  vs. MIN,MIN,1,41,21,20,-1,0,21,3,34,15,19,0,0,19,2
New Jersey Devils,2013/03/29  vs. TBL,TBL,1,33,33,0,7,-7,0,8,28,26,2,5,-3,0,5
Minnesota Wild,2013/01/22  vs. NSH,NSH,1,42,31,11,8,-2,5,6,29,24,5,3,0,2,3
Ottawa Senators,2013/01/30  vs. MTL,MTL,1,37,45,-8,1,-10,1,2,27,29,-2,5,-8,1,6
Vancouver Canucks,2013/01/25  vs. ANA,ANA,1,33,35,-2,-1,-1,0,1,28,29,-1,-4,3,0,-1
Chicago Blackhawks,2013/02/10  vs. NSH,NSH,1,44,39,5,7,-2,0,8,33,26,7,7,0,0,8
Boston Bruins,2013/03/09  vs. PHI,PHI,1,65,42,23,4,19,0,5,41,27,14,-1,15,0,0
Pittsburgh Penguins,2013/02/28  vs. CAR,CAR,1,45,37,8,0,1,7,-3,33,28,5,-1,1,5,-4
Phoenix Coyotes,2013/03/18  vs. LAK,LAK,1,41,36,5,-1,0,6,5,33,29,4,-1,0,5,3
Florida Panthers,2013/02/28  vs. BUF,BUF,1,56,31,25,5,0,20,21,45,22,23,4,0,19,18
New York Islanders,2013/04/09  vs. PHI,PHI,1,56,48,8,0,5,3,8,40,36,4,-4,7,1,1
Phoenix Coyotes,2013/02/11  vs. COL,COL,1,37,51,-14,-7,-4,-3,-18,28,45,-17,-8,-3,-6,-18
Montreal Canadiens,2013/03/30  vs. NYR,NYR,1,50,68,-18,-1,-17,0,-12,35,45,-10,-1,-9,0,-10
Florida Panthers,2013/03/03  vs. CAR,CAR,1,47,35,12,13,0,-1,12,39,25,14,11,0,3,10
Columbus Blue Jackets,2013/04/15  vs. COL,COL,1,55,53,2,1,2,-1,0,36,41,-5,-6,2,-1,-7
Dallas Stars,2013/04/01  vs. ANA,ANA,1,40,48,-8,1,0,-9,0,31,35,-4,1,0,-5,1
Phoenix Coyotes,2013/04/12  vs. CGY,CGY,1,54,38,16,17,-6,5,13,42,29,13,11,-5,7,8
Los Angeles Kings,2013/04/18  vs. CBJ,CBJ,1,34,34,0,3,-3,0,5,26,21,5,2,3,0,9
San Jose Sharks,2013/04/09  vs. CBJ,CBJ,1,51,41,10,3,0,7,5,39,33,6,0,0,6,3
Nashville Predators,2013/03/09  vs. MIN,MIN,1,39,35,4,7,0,-3,2,29,29,0,1,0,-1,-3
Nashville Predators,2013/02/25  vs. DAL,DAL,1,28,40,-12,-7,2,-7,-6,22,26,-4,-2,2,-4,-1
Chicago Blackhawks,2013/04/14  vs. STL,STL,1,38,39,-1,2,-3,0,8,32,31,1,1,0,0,8
Montreal Canadiens,2013/03/27  vs. BOS,BOS,1,33,45,-12,-5,-8,1,-11,26,32,-6,-2,-7,3,-7
Colorado Avalanche,2013/01/26  vs. SJS,SJS,1,58,54,4,-3,0,7,-3,36,34,2,3,0,-1,3
Winnipeg Jets,2013/02/24  vs. NJD,NJD,1,39,39,0,-1,2,-1,1,31,30,1,0,1,0,0
Colorado Avalanche,2013/01/24  vs. CBJ,CBJ,1,36,46,-10,0,-10,0,4,31,27,4,0,4,0,6
Colorado Avalanche,2013/02/18  vs. NSH,NSH,1,37,57,-20,2,-22,0,2,29,38,-9,1,-10,0,0
Toronto Maple Leafs,2013/04/25  vs. FLA,FLA,1,30,56,-26,-3,-23,0,-4,24,37,-13,-2,-11,0,-1
Ottawa Senators,2013/04/09  vs. TBL,TBL,1,55,26,29,20,2,7,26,41,21,20,14,1,5,17
Edmonton Oilers,2013/04/01  vs. CGY,CGY,1,44,59,-15,-4,-11,0,-14,29,48,-19,-3,-16,0,-10
Washington Capitals,2013/01/25  vs. NJD,NJD,1,27,29,-2,6,0,-8,-6,26,20,6,7,0,-1,2
San Jose Sharks,2013/04/13  vs. DAL,DAL,1,62,31,31,2,0,29,4,42,21,21,1,0,20,1
San Jose Sharks,2013/03/28  vs. DET,DET,1,51,59,-8,3,-11,0,-1,36,39,-3,-1,-2,0,-2
Pittsburgh Penguins,2013/03/28  vs. WPG,WPG,1,68,39,29,9,20,0,9,54,29,25,6,19,0,7
Colorado Avalanche,2013/03/10  vs. SJS,SJS,1,49,39,10,0,10,0,2,40,33,7,1,6,0,1
Winnipeg Jets,2013/03/07  vs. TBL,TBL,1,46,40,6,2,4,0,9,34,29,5,2,3,0,9
San Jose Sharks,2013/04/21  vs. CBJ,CBJ,1,64,45,19,6,0,13,6,46,28,18,9,0,9,5
New York Rangers,2013/03/05  vs. PHI,PHI,1,40,37,3,7,-4,0,5,30,24,6,10,-4,0,7
New Jersey Devils,2013/04/12  vs. OTT,OTT,1,44,23,21,8,0,13,5,35,15,20,8,0,12,6
Florida Panthers,2013/04/18  vs. NYR,NYR,1,50,47,3,0,0,3,-7,38,39,-1,-1,0,0,-6
St. Louis Blues,2013/01/27  vs. MIN,MIN,1,44,29,15,4,3,8,4,34,21,13,4,3,6,4
Winnipeg Jets,2013/03/30  vs. CAR,CAR,1,43,38,5,-2,0,7,7,31,29,2,-1,0,3,5
Phoenix Coyotes,2013/02/04  vs. MIN,MIN,1,56,43,13,9,4,0,10,43,31,12,5,7,0,4
Buffalo Sabres,2013/02/28  vs. FLA,FLA,1,31,56,-25,-5,-20,0,-21,22,45,-23,-4,-19,0,-18
Chicago Blackhawks,2013/03/31  vs. DET,DET,1,46,54,-8,2,-10,0,3,32,43,-11,0,-11,0,1
San Jose Sharks,2013/03/25  vs. ANA,ANA,1,40,52,-12,-2,-10,0,-5,36,34,2,-1,3,0,-5
Nashville Predators,2013/03/14  vs. VAN,VAN,1,37,36,1,-2,0,3,-2,30,29,1,0,0,1,-1
Montreal Canadiens,2013/04/17  vs. PIT,PIT,1,59,24,35,4,0,31,4,37,18,19,0,0,19,0
San Jose Sharks,2013/01/26  vs. COL,COL,1,54,58,-4,3,-7,0,3,34,36,-2,-3,1,0,-3
Buffalo Sabres,2013/01/27  vs. WSH,WSH,1,44,37,7,3,5,-1,7,30,29,1,-3,4,0,3
Montreal Canadiens,2013/02/19  vs. NYR,NYR,1,46,46,0,1,-3,2,3,26,31,-5,-2,-2,-1,-3
Dallas Stars,2013/02/13  vs. CGY,CGY,1,45,36,9,-2,0,11,-2,31,31,0,-2,0,2,-2
Ottawa Senators,2013/03/17  vs. WPG,WPG,1,54,35,19,2,17,0,8,46,28,18,0,18,0,3
Calgary Flames,2013/04/05  vs. SJS,SJS,1,34,67,-33,-30,-2,-1,-31,25,51,-26,-22,-3,-1,-24
Buffalo Sabres,2013/03/30  vs. WSH,WSH,1,31,49,-18,-1,-17,0,1,23,38,-15,0,-15,0,-2
Anaheim Ducks,2013/03/27  vs. SJS,SJS,1,54,42,12,0,0,12,-3,26,31,-5,0,0,-5,-2
Philadelphia Flyers,2013/02/15  vs. NJD,NJD,1,44,36,8,2,1,5,10,36,28,8,3,3,2,8
Washington Capitals,2013/03/14  vs. CAR,CAR,1,37,54,-17,-9,-1,-7,-24,27,39,-12,-8,-1,-3,-17
San Jose Sharks,2013/01/29  vs. ANA,ANA,1,41,46,-5,1,-6,0,-1,29,32,-3,2,-3,-2,2
Dallas Stars,2013/02/06  vs. EDM,EDM,1,49,40,9,12,-4,1,13,33,33,0,6,-4,-2,4
Toronto Maple Leafs,2013/02/09  vs. MTL,MTL,1,40,38,2,-3,5,0,3,29,27,2,-2,4,0,3
New York Islanders,2013/02/23  vs. BUF,BUF,1,48,38,10,11,-1,0,13,39,30,9,11,-2,0,13
Pittsburgh Penguins,2013/02/15  vs. WPG,WPG,1,52,51,1,2,-1,0,2,39,39,0,3,-3,0,0
Nashville Predators,2013/03/30  vs. COL,COL,1,42,51,-9,-9,0,0,-9,32,34,-2,-2,0,0,-2
Ottawa Senators,2013/01/24  vs. FLA,FLA,1,51,35,16,14,2,0,8,33,24,9,8,1,0,4
New York Islanders,2013/04/06  vs. TBL,TBL,1,50,50,0,4,-4,0,-2,33,27,6,3,3,0,2
St. Louis Blues,2013/04/19  vs. DAL,DAL,1,31,39,-8,1,-9,0,-1,22,27,-5,1,-6,0,-1
Phoenix Coyotes,2013/01/24  vs. SJS,SJS,1,45,47,-2,3,-11,6,7,30,33,-3,0,-8,5,3
Minnesota Wild,2013/03/18  vs. VAN,VAN,1,33,57,-24,-20,-5,1,-19,28,40,-12,-10,-3,1,-9
Philadelphia Flyers,2013/03/28  vs. NYI,NYI,1,49,55,-6,-8,0,2,-17,38,38,0,-5,4,1,-11
Montreal Canadiens,2013/04/27  vs. TOR,TOR,1,44,30,14,11,2,1,14,30,19,11,6,4,1,8
Detroit Red Wings,2013/02/09  vs. EDM,EDM,1,48,30,18,11,7,0,11,34,23,11,11,0,0,10
Boston Bruins,2013/03/14  vs. FLA,FLA,1,50,45,5,-5,10,0,2,40,33,7,-4,11,0,0
New York Rangers,2013/01/24  vs. PHI,PHI,1,36,52,-16,-2,0,-14,-5,20,40,-20,-6,0,-14,-8
Carolina Hurricanes,2013/03/14  vs. WSH,WSH,1,54,37,17,9,7,1,24,39,27,12,8,3,1,17
New York Rangers,2013/01/29  vs. PHI,PHI,1,42,37,5,0,5,0,4,29,26,3,-1,4,0,2
Nashville Predators,2013/04/19  vs. CHI,CHI,1,31,50,-19,-17,-1,-1,-16,26,38,-12,-9,-2,-1,-10
Boston Bruins,2013/02/02  vs. TOR,TOR,1,52,44,8,3,5,0,10,41,25,16,2,14,0,13
Vancouver Canucks,2013/03/12  vs. CBJ,CBJ,1,60,39,21,17,0,4,21,36,32,4,1,0,3,4
Phoenix Coyotes,2013/02/02  vs. DAL,DAL,1,42,36,6,1,5,0,4,30,23,7,4,3,0,5
Calgary Flames,2013/02/11  vs. MIN,MIN,1,40,31,9,17,0,-8,13,27,17,10,16,0,-6,13
Edmonton Oilers,2013/04/27  vs. VAN,VAN,1,54,47,7,-3,7,3,0,48,41,7,-4,7,4,0
Philadelphia Flyers,2013/04/25  vs. NYI,NYI,1,43,44,-1,-8,7,0,-3,32,29,3,-2,5,0,1
Colorado Avalanche,2013/03/08  vs. CHI,CHI,1,35,52,-17,-4,-15,2,-1,25,35,-10,1,-9,-2,0
Minnesota Wild,2013/03/03  vs. EDM,EDM,1,49,38,11,13,-2,0,12,43,26,17,15,2,0,17
Chicago Blackhawks,2013/04/06  vs. NSH,NSH,1,52,38,14,2,12,0,8,38,27,11,-1,12,0,8
Vancouver Canucks,2013/02/15  vs. DAL,DAL,1,37,29,8,3,2,3,-1,27,22,5,-1,4,2,-2
Washington Capitals,2013/04/27  vs. BOS,BOS,1,48,52,-4,-1,0,-3,-6,34,38,-4,-3,0,-1,-6
Montreal Canadiens,2013/03/09  vs. TBL,TBL,1,44,37,7,4,5,-2,5,36,25,11,5,4,2,6
Los Angeles Kings,2013/04/23  vs. MIN,MIN,1,42,41,1,-5,0,6,-5,33,36,-3,-4,0,1,-4
Dallas Stars,2013/04/18  vs. VAN,VAN,1,40,63,-23,-11,-6,-6,-17,33,53,-20,-10,-3,-7,-17
Buffalo Sabres,2013/03/10  vs. PHI,PHI,1,30,33,-3,-7,0,4,-8,18,24,-6,-4,0,-2,-7
Nashville Predators,2013/04/09  vs. STL,STL,1,29,51,-22,-18,0,-4,-21,20,35,-15,-15,0,0,-17
Chicago Blackhawks,2013/02/24  vs. CBJ,CBJ,1,41,23,18,8,10,0,12,32,16,16,5,11,0,9
New Jersey Devils,2013/04/01  vs. NYI,NYI,1,52,26,26,-1,0,27,5,33,22,11,-1,0,12,2
Pittsburgh Penguins,2013/04/25  vs. NJD,NJD,1,22,41,-19,-14,-2,-3,-14,18,37,-19,-16,-1,-2,-17
Dallas Stars,2013/01/20  vs. MIN,MIN,1,47,40,7,-4,0,11,13,28,32,-4,-4,0,0,5
Toronto Maple Leafs,2013/03/04  vs. NJD,NJD,1,35,58,-23,-10,-9,-4,-24,24,43,-19,-12,-4,-3,-23
New York Rangers,2013/04/06  vs. CAR,CAR,1,35,67,-32,-6,-26,0,-4,30,50,-20,-2,-18,0,0
Philadelphia Flyers,2013/02/21  vs. FLA,FLA,1,63,39,24,-1,0,25,-2,43,29,14,-1,0,15,-2
Winnipeg Jets,2013/01/19  vs. OTT,OTT,1,46,51,-5,0,-4,-1,-2,34,42,-8,-2,-1,-5,-4
New Jersey Devils,2013/04/20  vs. FLA,FLA,1,42,18,24,6,16,2,10,36,13,23,6,15,2,8
Pittsburgh Penguins,2013/03/30  vs. NYI,NYI,1,42,40,2,2,0,0,2,32,29,3,3,0,0,3
Ottawa Senators,2013/02/03  vs. MTL,MTL,1,57,43,14,-4,0,18,-6,36,34,2,-1,0,3,-4
St. Louis Blues,2013/04/14  vs. CHI,CHI,1,39,38,1,-2,0,3,-8,31,32,-1,-1,0,0,-8
Calgary Flames,2013/02/05  vs. DET,DET,1,33,52,-19,1,-20,0,-2,25,35,-10,1,-11,0,-1
Calgary Flames,2013/01/26  vs. EDM,EDM,1,35,26,9,-3,12,0,-2,28,20,8,-3,11,0,-5
Colorado Avalanche,2013/02/02  vs. EDM,EDM,1,38,38,0,-1,3,-2,-3,26,32,-6,-1,2,-7,-8
Anaheim Ducks,2013/02/06  vs. COL,COL,1,40,61,-21,2,-23,0,-6,27,41,-14,1,-15,0,-5
Los Angeles Kings,2013/03/16  vs. SJS,SJS,1,52,52,0,3,-3,0,8,38,33,5,2,3,0,1
Edmonton Oilers,2013/04/24  vs. CHI,CHI,1,35,46,-11,3,0,-14,-4,26,38,-12,2,0,-14,-4
Anaheim Ducks,2013/01/25  vs. VAN,VAN,1,35,33,2,1,0,1,-1,29,28,1,4,0,-3,1
Toronto Maple Leafs,2013/03/16  vs. WPG,WPG,1,43,64,-21,-1,-17,-3,-15,28,41,-13,0,-10,-3,-10
Vancouver Canucks,2013/03/28  vs. COL,COL,1,43,48,-5,5,-10,0,1,29,33,-4,4,-8,0,1
Winnipeg Jets,2013/04/25  vs. MTL,MTL,1,42,57,-15,0,-13,-2,-14,32,40,-8,0,-8,0,-9
Phoenix Coyotes,2013/03/12  vs. LAK,LAK,1,41,56,-15,-1,-14,0,3,32,34,-2,1,-3,0,5
Montreal Canadiens,2013/03/21  vs. NYI,NYI,1,38,41,-3,0,0,-3,-2,31,26,5,2,5,-2,2
Buffalo Sabres,2013/02/17  vs. PIT,PIT,1,42,44,-2,1,-2,-1,-1,30,35,-5,-1,-2,-2,-2
Winnipeg Jets,2013/02/07  vs. TOR,TOR,1,39,33,6,10,-4,0,13,32,17,15,12,2,1,14
St. Louis Blues,2013/04/05  vs. CBJ,CBJ,1,30,39,-9,1,-10,0,-2,21,29,-8,-1,-7,0,-3
Carolina Hurricanes,2013/04/18  vs. WPG,WPG,1,47,41,6,-1,0,7,3,27,29,-2,-5,0,3,-4
Los Angeles Kings,2013/03/28  vs. STL,STL,1,61,32,29,22,7,0,28,45,23,22,15,7,0,20
Philadelphia Flyers,2013/03/31  vs. WSH,WSH,1,40,48,-8,-2,-4,-2,-15,29,34,-5,-2,0,-3,-8
Buffalo Sabres,2013/03/17  vs. WSH,WSH,1,42,45,-3,-3,0,0,-2,32,29,3,-1,0,4,0
San Jose Sharks,2013/03/12  vs. STL,STL,1,65,28,37,2,0,35,29,47,21,26,6,0,20,20
Florida Panthers,2013/02/05  vs. WPG,WPG,1,33,47,-14,-5,-9,0,-14,24,29,-5,1,-6,0,-5
Nashville Predators,2013/01/31  vs. LAK,LAK,1,24,49,-25,-22,-3,0,-25,17,29,-12,-10,-2,0,-12
Calgary Flames,2013/02/15  vs. STL,STL,1,46,38,8,0,0,8,-3,31,31,0,0,0,0,-2
Calgary Flames,2013/03/15  vs. NSH,NSH,1,45,40,5,2,3,0,0,29,27,2,0,2,0,-2
Calgary Flames,2013/03/08  vs. ANA,ANA,1,64,41,23,-2,0,25,27,46,30,16,0,0,16,20
New Jersey Devils,2013/01/19  vs. NYI,NYI,1,45,31,14,8,6,0,9,32,22,10,3,7,0,5
Montreal Canadiens,2013/04/06  vs. BOS,BOS,1,51,63,-12,3,-15,0,-4,41,40,1,5,-4,0,3
Dallas Stars,2013/01/24  vs. CHI,CHI,1,36,54,-18,-5,-13,0,-10,29,37,-8,2,-10,0,-6
Carolina Hurricanes,2013/01/28  vs. BOS,BOS,1,34,45,-11,-11,0,0,-7,27,36,-9,-9,0,0,-4
Buffalo Sabres,2013/01/29  vs. TOR,TOR,1,50,34,16,9,3,4,12,37,24,13,8,2,3,10
Carolina Hurricanes,2013/03/07  vs. MTL,MTL,1,52,33,19,1,0,18,3,40,24,16,0,0,16,2
Washington Capitals,2013/01/19  vs. TBL,TBL,1,29,33,-4,-3,0,-1,-6,27,27,0,-1,0,1,-3
Pittsburgh Penguins,2013/04/20  vs. BOS,BOS,1,21,56,-35,-20,-9,-6,-26,17,42,-25,-14,-7,-4,-18
Anaheim Ducks,2013/03/14  vs. DAL,DAL,1,44,53,-9,-2,0,-7,-9,27,38,-11,-7,0,-4,-11
Montreal Canadiens,2013/03/13  vs. OTT,OTT,1,59,41,18,21,-3,0,16,41,23,18,20,-2,0,16
Phoenix Coyotes,2013/03/27  vs. MIN,MIN,1,37,53,-16,3,-10,-9,-4,29,41,-12,2,-5,-9,-4
Washington Capitals,2013/02/14  vs. TBL,TBL,1,66,44,22,1,21,0,13,49,36,13,0,13,0,9
New York Islanders,2013/04/01  vs. NJD,NJD,1,26,52,-26,1,-27,0,-5,22,33,-11,1,-12,0,-2
Ottawa Senators,2013/02/16  vs. TOR,TOR,1,52,42,10,1,0,9,7,37,34,3,1,0,2,4
Ottawa Senators,2013/02/01  vs. CAR,CAR,1,49,39,10,-4,0,14,3,36,32,4,-3,0,7,4
Boston Bruins,2013/03/02  vs. TBL,TBL,1,35,22,13,10,0,3,10,28,15,13,12,0,1,12
Minnesota Wild,2013/04/18  vs. SJS,SJS,1,59,52,7,-1,0,8,-10,41,40,1,0,0,1,-8
Tampa Bay Lightning,2013/04/04  vs. CAR,CAR,1,48,78,-30,-14,-16,0,-18,39,60,-21,-10,-11,0,-10
Carolina Hurricanes,2013/04/08  vs. BOS,BOS,1,66,51,15,5,0,10,10,51,39,12,7,0,5,11
Vancouver Canucks,2013/04/01  vs. SJS,SJS,1,62,49,13,-5,0,18,-6,37,40,-3,-9,0,6,-10
Ottawa Senators,2013/03/02  vs. PHI,PHI,1,44,46,-2,-11,0,9,-12,34,30,4,-4,0,8,-6
Calgary Flames,2013/03/13  vs. DET,DET,1,33,64,-31,-16,-17,2,-25,28,48,-20,-14,-8,2,-16
Detroit Red Wings,2013/02/27  vs. LAK,LAK,1,40,36,4,5,4,-5,0,34,31,3,5,2,-4,-1
Chicago Blackhawks,2013/04/26  vs. CGY,CGY,1,68,35,33,3,30,0,6,48,27,21,2,19,0,3
Detroit Red Wings,2013/02/21  vs. CBJ,CBJ,1,32,39,-7,4,-10,-1,-10,24,27,-3,2,-4,-1,-5
New York Islanders,2013/01/29  vs. PIT,PIT,1,40,58,-18,3,-21,0,1,26,49,-23,-4,-19,0,-6
Pittsburgh Penguins,2013/02/26  vs. FLA,FLA,1,49,39,10,-2,0,12,-1,39,28,11,-2,0,13,0
Toronto Maple Leafs,2013/02/23  vs. OTT,OTT,1,50,64,-14,-5,-6,-3,-12,34,42,-8,-4,-3,-1,-8
Ottawa Senators,2013/02/09  vs. WPG,WPG,1,67,50,17,1,0,16,1,48,43,5,-7,0,12,-7
Florida Panthers,2013/04/13  vs. PIT,PIT,1,43,34,9,0,0,9,2,28,26,2,2,0,0,-1
Dallas Stars,2013/01/19  vs. PHX,PHX,1,49,49,0,-1,0,1,5,37,37,0,0,0,0,3
Toronto Maple Leafs,2013/02/28  vs. NYI,NYI,1,51,52,-1,7,-6,-2,3,37,36,1,6,-4,-1,3
St. Louis Blues,2013/03/28  vs. LAK,LAK,1,32,61,-29,-22,0,-7,-28,23,45,-22,-15,0,-7,-20
Boston Bruins,2013/04/08  vs. CAR,CAR,1,51,66,-15,-5,-10,0,-10,39,51,-12,-7,-5,0,-11
Dallas Stars,2013/01/22  vs. DET,DET,1,37,44,-7,-3,-4,0,0,27,36,-9,-2,-7,0,-1
Boston Bruins,2013/03/05  vs. WSH,WSH,1,58,56,2,-1,3,0,0,40,39,1,-3,4,0,-3
Buffalo Sabres,2013/02/03  vs. FLA,FLA,1,39,45,-6,-5,-2,1,-9,28,34,-6,-5,-2,1,-11
Toronto Maple Leafs,2013/01/31  vs. WSH,WSH,1,55,38,17,2,-4,19,13,42,26,16,6,-2,12,12
New York Islanders,2013/03/16  vs. FLA,FLA,1,48,60,-12,-4,-8,0,-3,31,44,-13,-4,-9,0,-2
Carolina Hurricanes,2013/04/27  vs. PIT,PIT,1,49,51,-2,2,0,-4,3,36,43,-7,1,0,-8,-1
Ottawa Senators,2013/03/28  vs. NYR,NYR,1,45,44,1,9,-8,0,8,29,28,1,7,-6,0,5
Buffalo Sabres,2013/03/26  vs. TBL,TBL,1,34,26,8,5,0,3,0,22,24,-2,2,0,-4,-5
Montreal Canadiens,2013/01/29  vs. WPG,WPG,1,33,24,9,12,-4,1,11,27,12,15,11,3,1,16
Ottawa Senators,2013/02/07  vs. CAR,CAR,1,63,36,27,17,10,0,31,45,26,19,9,10,0,21
Boston Bruins,2013/03/23  vs. TOR,TOR,1,70,30,40,-1,0,41,15,43,21,22,0,0,22,8
Philadelphia Flyers,2013/04/04  vs. TOR,TOR,1,42,59,-17,-5,-11,-1,-7,33,41,-8,-4,-3,-1,-5
Buffalo Sabres,2013/04/23  vs. PIT,PIT,1,49,61,-12,-15,3,0,-12,36,42,-6,-7,1,0,-5
Philadelphia Flyers,2013/04/20  vs. CAR,CAR,1,52,46,6,13,-7,0,12,47,37,10,13,-3,0,15
Vancouver Canucks,2013/03/23  vs. LAK,LAK,1,19,40,-21,-2,-19,0,-15,16,31,-15,-2,-13,0,-8
Boston Bruins,2013/03/31  vs. BUF,BUF,1,52,42,10,9,1,0,9,39,32,7,5,2,0,5
Winnipeg Jets,2013/01/25  vs. PIT,PIT,1,50,65,-15,-9,-5,-1,-14,41,48,-7,-9,1,1,-11
Colorado Avalanche,2013/01/31  vs. CGY,CGY,1,30,57,-27,-17,-2,-8,-28,26,40,-14,-7,0,-7,-15
Chicago Blackhawks,2013/03/29  vs. ANA,ANA,1,37,33,4,1,0,3,6,29,25,4,2,0,2,5
Dallas Stars,2013/03/21  vs. LAK,LAK,1,37,49,-12,-13,1,0,-13,27,43,-16,-17,1,0,-17
Ottawa Senators,2013/04/25  vs. WSH,WSH,1,45,31,14,3,11,0,6,36,23,13,2,11,0,6
Tampa Bay Lightning,2013/03/09  vs. MTL,MTL,1,37,44,-7,-4,2,-5,-5,25,36,-11,-5,-2,-4,-6
Florida Panthers,2013/03/14  vs. BOS,BOS,1,45,50,-5,5,0,-10,-2,33,40,-7,4,0,-11,0
Florida Panthers,2013/03/10  vs. MTL,MTL,1,30,42,-12,-4,0,-8,-6,22,38,-16,-3,0,-13,-6
Boston Bruins,2013/04/21  vs. FLA,FLA,1,55,45,10,0,10,0,3,43,37,6,0,6,0,1
New York Islanders,2013/04/16  vs. FLA,FLA,1,41,51,-10,9,-19,0,12,35,33,2,6,-4,0,9
Nashville Predators,2013/04/25  vs. DET,DET,1,25,50,-25,-10,-9,-6,-19,22,41,-19,-7,-7,-5,-14
Phoenix Coyotes,2013/04/26  vs. COL,COL,1,41,34,7,2,-1,6,4,32,23,9,1,0,8,6
Washington Capitals,2013/03/21  vs. WPG,WPG,1,35,41,-6,0,-6,0,1,21,26,-5,0,-5,0,-1
San Jose Sharks,2013/04/11  vs. DET,DET,1,34,41,-7,-5,-3,1,-8,29,28,1,-1,1,1,0
St. Louis Blues,2013/02/05  vs. NSH,NSH,1,37,28,9,-1,0,10,-1,25,23,2,-1,0,3,-1
Toronto Maple Leafs,2013/01/29  vs. BUF,BUF,1,34,50,-16,-9,-4,-3,-12,24,37,-13,-8,-3,-2,-10
Philadelphia Flyers,2013/04/06  vs. WPG,WPG,1,48,53,-5,-3,-3,1,-7,35,37,-2,-4,2,0,-3
Chicago Blackhawks,2013/02/12  vs. ANA,ANA,1,31,34,-3,0,-3,0,3,26,22,4,5,0,-1,6
Toronto Maple Leafs,2013/04/18  vs. NYI,NYI,1,48,52,-4,-5,-8,9,-20,29,43,-14,-5,-8,-1,-17
Calgary Flames,2013/04/06  vs. VAN,VAN,1,52,33,19,0,0,19,8,40,24,16,0,0,16,8
Florida Panthers,2013/02/12  vs. WSH,WSH,1,36,48,-12,-6,-6,0,-2,28,35,-7,-6,0,-1,-2
Los Angeles Kings,2013/02/15  vs. CBJ,CBJ,1,31,19,12,10,2,0,10,26,14,12,11,1,0,11
Toronto Maple Leafs,2013/02/16  vs. OTT,OTT,1,42,52,-10,-1,-9,0,-7,34,37,-3,-1,-2,0,-4
Florida Panthers,2013/02/18  vs. TOR,TOR,1,49,37,12,8,0,4,13,42,31,11,10,0,1,13
Ottawa Senators,2013/01/25  vs. TBL,TBL,1,53,48,5,4,-1,2,0,38,36,2,2,1,-1,0
Nashville Predators,2013/04/07  vs. CHI,CHI,1,33,60,-27,-10,1,-18,-24,23,44,-21,-7,3,-17,-18
Montreal Canadiens,2013/03/02  vs. PIT,PIT,1,52,50,2,-1,-4,7,3,40,39,1,0,-3,4,2
New York Rangers,2013/03/21  vs. FLA,FLA,1,68,35,33,2,0,31,6,47,29,18,-1,0,19,3
Tampa Bay Lightning,2013/03/23  vs. OTT,OTT,1,44,43,1,-2,0,3,-3,31,32,-1,-1,0,0,-3
Vancouver Canucks,2013/04/22  vs. CHI,CHI,1,40,37,3,9,-6,0,4,29,26,3,5,-2,0,4
Ottawa Senators,2013/04/18  vs. WSH,WSH,1,59,31,28,17,11,0,25,46,23,23,13,10,0,23
New York Rangers,2013/04/10  vs. TOR,TOR,1,49,35,14,3,10,1,11,33,29,4,-2,7,-1,1
Los Angeles Kings,2013/02/25  vs. ANA,ANA,1,55,32,23,12,9,2,14,39,24,15,9,4,2,11
Winnipeg Jets,2013/02/23  vs. PHI,PHI,1,41,47,-6,0,-9,3,-8,32,35,-3,1,-7,3,-5
Montreal Canadiens,2013/04/20  vs. WSH,WSH,1,48,43,5,2,0,3,-1,33,27,6,5,0,1,2
Pittsburgh Penguins,2013/03/04  vs. TBL,TBL,1,42,51,-9,-13,5,-1,-12,29,38,-9,-11,6,-4,-12
New Jersey Devils,2013/03/15  vs. PHI,PHI,1,27,23,4,0,0,4,4,21,16,5,4,0,1,5
Edmonton Oilers,2013/02/28  vs. DAL,DAL,1,34,49,-15,1,-16,0,-11,27,34,-7,1,-8,0,-10
Los Angeles Kings,2013/01/24  vs. EDM,EDM,1,34,24,10,9,1,0,6,24,17,7,6,1,0,4
Montreal Canadiens,2013/01/30  vs. OTT,OTT,1,45,37,8,-1,-1,10,-2,29,27,2,-5,-1,8,-6
New York Rangers,2013/03/16  vs. PIT,PIT,1,39,50,-11,-1,0,-10,-5,26,37,-11,-1,0,-10,-9
Buffalo Sabres,2013/02/23  vs. NYI,NYI,1,38,48,-10,-11,0,1,-13,30,39,-9,-11,0,2,-13
Philadelphia Flyers,2013/02/01  vs. WSH,WSH,1,51,34,17,4,7,6,11,33,25,8,4,4,0,8
Los Angeles Kings,2013/04/06  vs. EDM,EDM,1,49,32,17,1,16,0,4,38,24,14,-1,15,0,1
Washington Capitals,2013/04/07  vs. TBL,TBL,1,52,48,4,4,-3,3,9,42,33,9,3,0,6,11
Vancouver Canucks,2013/02/19  vs. CHI,CHI,1,33,44,-11,-2,1,-10,-3,22,35,-13,0,-3,-10,-4
Phoenix Coyotes,2013/04/04  vs. DET,DET,1,35,43,-8,4,2,-14,-5,30,34,-4,4,-2,-6,2
Anaheim Ducks,2013/03/29  vs. CHI,CHI,1,33,37,-4,-1,-3,0,-6,25,29,-4,-2,-2,0,-5
Colorado Avalanche,2013/03/24  vs. VAN,VAN,1,36,46,-10,-4,0,-6,-5,26,33,-7,-4,0,-3,-3
New Jersey Devils,2013/02/18  vs. OTT,OTT,1,33,35,-2,1,-3,0,-3,27,33,-6,0,-6,0,-5
New York Rangers,2013/02/21  vs. OTT,OTT,1,46,47,-1,1,-3,1,-8,34,35,-1,2,-3,0,-3
Anaheim Ducks,2013/04/13  vs. LAK,LAK,1,33,47,-14,0,0,-14,-11,27,36,-9,3,0,-12,-7
Minnesota Wild,2013/04/27  vs. COL,COL,1,36,49,-13,-7,-6,0,2,31,37,-6,-5,-1,0,6
Anaheim Ducks,2013/03/08  vs. CGY,CGY,1,41,64,-23,2,-25,0,-27,30,46,-16,0,-16,0,-20
Washington Capitals,2013/03/12  vs. CAR,CAR,1,43,53,-10,-4,0,-6,-11,33,34,-1,-1,0,0,-3
Phoenix Coyotes,2013/04/27  vs. ANA,ANA,1,50,60,-10,-5,-5,0,3,36,49,-13,-9,-4,0,-1
Boston Bruins,2013/04/13  vs. CAR,CAR,1,54,59,-5,2,-9,2,-9,39,47,-8,-1,-7,0,-11
Nashville Predators,2013/01/28  vs. PHX,PHX,1,40,36,4,1,0,3,2,30,29,1,0,0,1,1
San Jose Sharks,2013/04/15  vs. PHX,PHX,1,54,57,-3,7,-10,0,7,43,47,-4,2,-6,0,2
Pittsburgh Penguins,2013/03/10  vs. NYI,NYI,1,40,38,2,0,2,0,4,27,30,-3,2,-5,0,4
Ottawa Senators,2013/03/03  vs. NYI,NYI,1,42,56,-14,-5,0,-9,-11,31,38,-7,0,0,-7,-5
St. Louis Blues,2013/03/14  vs. PHX,PHX,1,42,43,-1,5,-6,0,1,33,31,2,7,-5,0,3
Philadelphia Flyers,2013/01/20  vs. BUF,BUF,1,25,40,-15,-2,-5,-8,-12,24,28,-4,5,-4,-5,-1
Tampa Bay Lightning,2013/02/07  vs. NJD,NJD,1,20,32,-12,-12,0,0,-14,15,27,-12,-9,0,-3,-13
Dallas Stars,2013/02/25  vs. NSH,NSH,1,40,28,12,7,7,-2,6,26,22,4,2,4,-2,1
Edmonton Oilers,2013/04/13  vs. CGY,CGY,1,40,49,-9,-5,0,-4,-10,33,34,-1,-3,0,2,-7
Anaheim Ducks,2013/02/04  vs. SJS,SJS,1,39,42,-3,-2,2,-3,-1,29,26,3,2,4,-3,3
Buffalo Sabres,2013/04/19  vs. NYR,NYR,1,45,43,2,-7,0,9,-6,30,33,-3,-3,0,0,-3
Columbus Blue Jackets,2013/04/13  vs. MIN,MIN,1,33,48,-15,-7,-12,4,-9,21,39,-18,-7,-11,0,-11
Nashville Predators,2013/02/16  vs. ANA,ANA,1,47,41,6,2,4,0,6,34,27,7,5,2,0,7
Anaheim Ducks,2013/03/25  vs. SJS,SJS,1,52,40,12,2,0,10,5,34,36,-2,1,0,-3,5
Phoenix Coyotes,2013/04/08  vs. VAN,VAN,1,38,51,-13,-7,0,-6,-17,30,41,-11,-4,0,-7,-12
New Jersey Devils,2013/02/23  vs. WSH,WSH,1,35,32,3,-1,0,4,3,25,25,0,-4,0,4,-2
San Jose Sharks,2013/01/24  vs. PHX,PHX,1,47,45,2,-3,-6,11,-7,33,30,3,0,-5,8,-3
Calgary Flames,2013/02/24  vs. PHX,PHX,1,40,31,9,-5,6,8,4,33,27,6,-6,6,6,2
Winnipeg Jets,2013/03/08  vs. FLA,FLA,1,43,46,-3,2,-5,0,0,28,39,-11,-5,-6,0,-8
Detroit Red Wings,2013/02/02  vs. CBJ,CBJ,1,43,26,17,4,3,10,14,34,22,12,4,3,5,13
Toronto Maple Leafs,2013/02/25  vs. PHI,PHI,1,39,40,-1,-4,3,0,-3,27,32,-5,-7,2,0,-5
Toronto Maple Leafs,2013/01/24  vs. NYI,NYI,1,48,45,3,-1,6,-2,5,35,39,-4,-2,5,-7,3
Vancouver Canucks,2013/04/20  vs. DET,DET,1,22,41,-19,-15,-4,0,-19,13,32,-19,-17,-2,0,-19
Tampa Bay Lightning,2013/01/27  vs. PHI,PHI,1,31,48,-17,0,-18,1,2,25,29,-4,1,-6,1,3
Philadelphia Flyers,2013/01/19  vs. PIT,PIT,1,36,44,-8,-1,0,-7,6,26,35,-9,-1,0,-8,2
Detroit Red Wings,2013/03/07  vs. EDM,EDM,1,57,39,18,3,15,0,10,39,26,13,4,9,0,8
St. Louis Blues,2013/03/07  vs. PHX,PHX,1,37,39,-2,1,-5,2,0,31,24,7,3,2,2,7
Montreal Canadiens,2013/02/27  vs. TOR,TOR,1,60,50,10,14,-2,-2,12,43,35,8,11,-1,-2,8
Chicago Blackhawks,2013/02/07  vs. PHX,PHX,1,42,40,2,4,-2,0,6,32,27,5,6,-1,0,6
Phoenix Coyotes,2013/03/06  vs. ANA,ANA,1,47,34,13,-5,0,18,-2,31,23,8,-5,0,13,-5
St. Louis Blues,2013/03/26  vs. EDM,EDM,1,54,33,21,5,0,16,11,46,24,22,4,0,18,8
St. Louis Blues,2013/04/01  vs. MIN,MIN,1,46,36,10,9,1,0,23,30,27,3,6,-3,0,15
Los Angeles Kings,2013/01/31  vs. NSH,NSH,1,49,24,25,22,0,3,25,29,17,12,10,0,2,12
New Jersey Devils,2013/03/16  vs. MTL,MTL,1,46,29,17,9,0,8,16,32,24,8,5,0,3,9
Tampa Bay Lightning,2013/04/14  vs. BUF,BUF,1,47,33,14,-1,0,15,5,40,25,15,-2,0,17,7
Montreal Canadiens,2013/03/26  vs. PIT,PIT,1,60,35,25,14,0,11,18,44,23,21,12,0,9,16
Los Angeles Kings,2013/03/30  vs. MIN,MIN,1,44,39,5,2,3,0,9,36,31,5,3,2,0,7
Buffalo Sabres,2013/03/23  vs. MTL,MTL,1,22,70,-48,-32,-16,0,-34,16,45,-29,-22,-7,0,-21
New Jersey Devils,2013/03/07  vs. BUF,BUF,1,44,38,6,-5,0,11,-2,36,30,6,-3,0,9,0
New York Islanders,2013/03/10  vs. PIT,PIT,1,38,40,-2,0,0,-2,-4,30,27,3,-2,0,5,-4
Ottawa Senators,2013/02/13  vs. PIT,PIT,1,52,35,17,9,4,4,13,33,28,5,1,4,0,4
Colorado Avalanche,2013/02/26  vs. SJS,SJS,1,46,45,1,1,0,0,-1,34,32,2,0,0,2,-1
Carolina Hurricanes,2013/03/09  vs. NJD,NJD,1,32,51,-19,4,-23,0,3,26,37,-11,2,-13,0,1
Florida Panthers,2013/01/29  vs. TBL,TBL,1,37,32,5,4,0,1,1,27,29,-2,3,0,-5,0
Los Angeles Kings,2013/04/07  vs. ANA,ANA,1,61,25,36,15,0,21,18,39,21,18,10,0,8,8
Nashville Predators,2013/04/06  vs. CHI,CHI,1,38,52,-14,-2,0,-12,-8,27,38,-11,1,0,-12,-8
New York Rangers,2013/02/26  vs. WPG,WPG,1,48,39,9,-8,0,17,-12,34,29,5,-4,0,9,-7
Columbus Blue Jackets,2013/02/11  vs. SJS,SJS,1,42,32,10,1,9,0,5,34,27,7,0,7,0,-1
Nashville Predators,2013/04/23  vs. CGY,CGY,1,60,32,28,19,11,-2,17,44,26,18,15,6,-3,12
Winnipeg Jets,2013/02/09  vs. OTT,OTT,1,50,67,-17,-1,-16,0,-1,43,48,-5,7,-12,0,7
Anaheim Ducks,2013/03/12  vs. MIN,MIN,1,33,45,-12,-7,1,-6,-12,24,27,-3,0,2,-5,-2
Pittsburgh Penguins,2013/01/29  vs. NYI,NYI,1,58,40,18,-3,0,21,-1,49,26,23,4,0,19,6
Winnipeg Jets,2013/04/02  vs. NYI,NYI,1,45,64,-19,-16,-1,-2,-20,30,49,-19,-12,-1,-6,-15
Dallas Stars,2013/02/12  vs. EDM,EDM,1,43,39,4,7,2,-5,2,33,31,2,5,4,-7,-2
Detroit Red Wings,2013/04/05  vs. COL,COL,1,45,54,-9,-2,-7,0,-3,29,33,-4,-4,0,0,0
Boston Bruins,2013/03/16  vs. WSH,WSH,1,46,44,2,1,1,0,2,39,35,4,0,4,0,1
Pittsburgh Penguins,2013/01/23  vs. TOR,TOR,1,40,29,11,10,-4,5,5,31,19,12,11,-3,4,7
Buffalo Sabres,2013/02/07  vs. MTL,MTL,1,38,37,1,1,0,0,-1,31,30,1,1,0,0,-1
Minnesota Wild,2013/04/26  vs. EDM,EDM,1,66,37,29,-1,0,30,5,48,27,21,-1,0,22,3
Minnesota Wild,2013/01/29  vs. CBJ,CBJ,1,35,39,-4,-9,5,0,-1,28,28,0,-5,5,0,4
Carolina Hurricanes,2013/02/21  vs. WPG,WPG,1,46,46,0,-2,0,2,0,36,29,7,7,0,0,7
Carolina Hurricanes,2013/04/16  vs. OTT,OTT,1,50,37,13,6,0,7,3,35,30,5,6,0,-1,2
Minnesota Wild,2013/02/01  vs. ANA,ANA,1,38,57,-19,-14,-2,-3,-16,28,38,-10,-8,1,-3,-7
New York Islanders,2013/02/21  vs. MTL,MTL,1,45,45,0,5,0,-5,0,25,31,-6,5,0,-11,-2
Nashville Predators,2013/02/07  vs. LAK,LAK,1,19,57,-38,-1,-37,0,-14,15,39,-24,0,-24,0,-7
San Jose Sharks,2013/03/10  vs. COL,COL,1,39,49,-10,0,0,-10,-2,33,40,-7,-1,0,-6,-1
Nashville Predators,2013/04/14  vs. DET,DET,1,35,62,-27,-12,0,-15,-19,24,42,-18,-8,0,-10,-14
Phoenix Coyotes,2013/02/18  vs. CGY,CGY,1,68,47,21,1,20,0,14,52,37,15,1,14,0,8
Montreal Canadiens,2013/02/02  vs. BUF,BUF,1,41,36,5,14,-9,0,12,31,27,4,12,-8,0,11
Washington Capitals,2013/01/29  vs. OTT,OTT,1,36,33,3,-3,5,1,-2,29,25,4,-2,5,1,-2
Chicago Blackhawks,2013/04/01  vs. NSH,NSH,1,47,40,7,8,-1,0,20,32,30,2,4,-2,0,10
Minnesota Wild,2013/02/04  vs. PHX,PHX,1,43,56,-13,-9,0,-4,-10,31,43,-12,-5,0,-7,-4
Anaheim Ducks,2013/03/16  vs. STL,STL,1,42,38,4,8,-4,0,4,26,28,-2,2,-4,0,-2
Florida Panthers,2013/04/21  vs. BOS,BOS,1,45,55,-10,0,0,-10,-3,37,43,-6,0,0,-6,-1
Buffalo Sabres,2013/03/28  vs. FLA,FLA,1,39,42,-3,-1,-4,2,1,34,36,-2,0,-4,2,2
Carolina Hurricanes,2013/04/06  vs. NYR,NYR,1,67,35,32,6,0,26,4,50,30,20,2,0,18,0
Carolina Hurricanes,2013/02/26  vs. WSH,WSH,1,57,61,-4,-4,0,0,-9,40,47,-7,-2,0,-5,-4
San Jose Sharks,2013/02/26  vs. COL,COL,1,45,46,-1,-1,0,0,1,32,34,-2,0,-2,0,1
Ottawa Senators,2013/03/11  vs. BOS,BOS,1,36,46,-10,-15,5,0,-6,31,36,-5,-12,7,0,-2
Chicago Blackhawks,2013/04/20  vs. PHX,PHX,1,46,39,7,8,0,-1,7,34,27,7,7,0,0,7
Washington Capitals,2013/03/07  vs. FLA,FLA,1,40,56,-16,-5,-11,0,-4,30,37,-7,-5,-2,0,-3
Winnipeg Jets,2013/03/19  vs. BOS,BOS,1,41,47,-6,3,2,-11,-2,28,34,-6,0,1,-7,-3
Montreal Canadiens,2013/03/07  vs. CAR,CAR,1,33,52,-19,-1,-18,0,-3,24,40,-16,0,-16,0,-2
Detroit Red Wings,2013/03/15  vs. EDM,EDM,1,38,40,-2,-1,0,-1,-5,25,33,-8,-5,0,-3,-11
Winnipeg Jets,2013/03/24  vs. TBL,TBL,1,40,38,2,-5,7,0,-5,27,29,-2,-5,3,0,-4
Colorado Avalanche,2013/03/20  vs. DAL,DAL,1,41,50,-9,4,1,-14,-8,34,33,1,3,2,-4,-1
New York Rangers,2013/02/05  vs. NJD,NJD,1,34,27,7,3,0,4,2,27,22,5,2,0,3,0
Edmonton Oilers,2013/03/12  vs. COL,COL,1,41,49,-8,-2,-6,0,-3,39,40,-1,0,-1,0,0
Boston Bruins,2013/03/19  vs. WPG,WPG,1,47,41,6,-3,11,-2,2,34,28,6,0,7,-1,3
Anaheim Ducks,2013/04/08  vs. EDM,EDM,1,50,38,12,3,9,0,12,34,33,1,-4,5,0,3
Detroit Red Wings,2013/04/14  vs. NSH,NSH,1,62,35,27,12,15,0,19,42,24,18,8,10,0,14
Buffalo Sabres,2013/04/07  vs. NJD,NJD,1,29,44,-15,0,-15,0,-12,19,29,-10,1,-11,0,-8
Philadelphia Flyers,2013/03/13  vs. NJD,NJD,1,27,42,-15,-4,0,-11,-5,19,32,-13,-3,0,-10,-3
Colorado Avalanche,2013/03/14  vs. MIN,MIN,1,49,53,-4,-4,0,0,-6,36,40,-4,-3,0,-1,-7
Buffalo Sabres,2013/04/05  vs. OTT,OTT,1,38,45,-7,-4,-1,-2,-7,32,35,-3,0,-1,-2,-2
Columbus Blue Jackets,2013/02/07  vs. CGY,CGY,1,26,45,-19,-10,-8,-1,-19,21,32,-11,-3,-7,-1,-11
St. Louis Blues,2013/01/24  vs. NSH,NSH,1,27,25,2,4,-2,0,8,19,16,3,4,-1,0,7
Calgary Flames,2013/02/26  vs. MIN,MIN,1,14,31,-17,1,-18,0,-12,11,20,-9,2,-11,0,-6
Columbus Blue Jackets,2013/02/16  vs. PHX,PHX,1,41,32,9,-2,0,11,4,23,24,-1,-5,1,3,-1
Dallas Stars,2013/04/27  vs. DET,DET,1,40,61,-21,-13,0,-8,-14,24,48,-24,-14,0,-10,-21
Boston Bruins,2013/04/23  vs. PHI,PHI,1,61,44,17,4,0,13,5,43,34,9,3,0,6,3
Washington Capitals,2013/03/09  vs. NYI,NYI,1,41,44,-3,9,0,-12,0,27,35,-8,8,0,-16,-4
Ottawa Senators,2013/03/06  vs. TOR,TOR,1,81,49,32,9,0,23,10,59,37,22,6,0,16,6
Calgary Flames,2013/03/21  vs. NSH,NSH,1,43,32,11,1,-1,11,-1,27,24,3,-1,0,4,-3
Phoenix Coyotes,2013/04/02  vs. LAK,LAK,1,49,51,-2,-7,5,0,-5,41,43,-2,-8,6,0,-6
Anaheim Ducks,2013/03/06  vs. PHX,PHX,1,34,47,-13,5,-18,0,2,23,31,-8,5,-13,0,5
Dallas Stars,2013/01/29  vs. DET,DET,1,32,32,0,5,-2,-3,3,25,27,-2,0,-1,-1,-1
Montreal Canadiens,2013/01/27  vs. NJD,NJD,1,45,28,17,0,17,0,10,34,24,10,-1,11,0,4
Ottawa Senators,2013/01/29  vs. WSH,WSH,1,33,36,-3,3,-1,-5,2,25,29,-4,2,-1,-5,2
Carolina Hurricanes,2013/01/22  vs. TBL,TBL,1,51,28,23,2,0,21,7,37,22,15,0,0,15,3
Buffalo Sabres,2013/02/26  vs. TBL,TBL,1,34,38,-4,3,-4,-3,0,27,31,-4,0,-3,-1,-1
Detroit Red Wings,2013/03/09  vs. CBJ,CBJ,1,33,28,5,-3,0,8,-1,28,23,5,-2,0,7,-1
Edmonton Oilers,2013/04/04  vs. VAN,VAN,1,34,36,-2,-6,0,4,-10,25,32,-7,-7,0,0,-12
Tampa Bay Lightning,2013/02/01  vs. WPG,WPG,1,25,41,-16,-5,-11,0,-6,20,31,-11,-5,-6,0,-5
New Jersey Devils,2013/03/05  vs. TBL,TBL,1,39,25,14,7,0,7,13,31,20,11,7,0,4,12
New York Islanders,2013/03/19  vs. OTT,OTT,1,30,40,-10,-8,0,-2,-6,23,27,-4,-1,1,-4,0
Phoenix Coyotes,2013/04/24  vs. SJS,SJS,1,43,55,-12,3,-15,0,-4,32,39,-7,-1,-6,0,-3
Pittsburgh Penguins,2013/02/13  vs. OTT,OTT,1,35,52,-17,-9,-4,-4,-13,28,33,-5,-1,0,-4,-4
Colorado Avalanche,2013/04/01  vs. DET,DET,1,27,33,-6,-2,0,-4,-2,21,29,-8,-3,0,-5,-4
Philadelphia Flyers,2013/02/02  vs. CAR,CAR,1,30,63,-33,-4,-29,0,-8,25,45,-20,0,-20,0,-5
San Jose Sharks,2013/03/02  vs. NSH,NSH,1,59,44,15,11,4,0,7,43,22,21,10,11,0,13
Chicago Blackhawks,2013/02/01  vs. VAN,VAN,1,33,25,8,-1,0,9,6,23,19,4,0,0,4,3
Tampa Bay Lightning,2013/01/19  vs. WSH,WSH,1,33,29,4,3,1,0,6,27,27,0,1,-1,0,3
Los Angeles Kings,2013/04/21  vs. DAL,DAL,1,46,32,14,7,4,3,11,36,28,8,4,3,1,6
Ottawa Senators,2013/02/05  vs. BUF,BUF,1,51,33,18,7,11,0,10,32,24,8,3,5,0,4
Columbus Blue Jackets,2013/01/28  vs. DAL,DAL,1,28,33,-5,-4,-5,4,0,20,26,-6,-6,-4,4,-2
Columbus Blue Jackets,2013/03/16  vs. PHX,PHX,1,39,61,-22,-22,0,0,-22,28,42,-14,-14,0,0,-14
Boston Bruins,2013/01/23  vs. NYR,NYR,1,47,38,9,-5,0,14,-1,29,33,-4,-9,0,5,-8
Anaheim Ducks,2013/02/24  vs. COL,COL,1,45,45,0,-4,0,4,4,35,28,7,2,0,5,9
Washington Capitals,2013/02/12  vs. FLA,FLA,1,48,36,12,6,0,6,2,35,28,7,6,1,0,2
New York Rangers,2013/03/18  vs. CAR,CAR,1,59,56,3,-8,0,11,3,45,40,5,-4,0,9,5
Calgary Flames,2013/02/17  vs. DAL,DAL,1,39,46,-7,-2,-5,0,-2,30,34,-4,-2,0,-2,-1
Toronto Maple Leafs,2013/03/30  vs. OTT,OTT,1,32,44,-12,3,-15,0,-3,20,32,-12,2,-14,0,-4
Columbus Blue Jackets,2013/04/07  vs. MIN,MIN,1,36,30,6,4,0,2,6,22,22,0,0,0,0,1
Detroit Red Wings,2013/02/07  vs. STL,STL,1,41,45,-4,0,-4,0,6,34,34,0,2,-2,0,6
New Jersey Devils,2013/02/05  vs. NYR,NYR,1,27,34,-7,-3,-4,0,-2,22,27,-5,-2,-3,0,0
Anaheim Ducks,2013/04/25  vs. VAN,VAN,1,41,47,-6,4,-10,0,4,28,34,-6,4,-10,0,4
New Jersey Devils,2013/01/29  vs. BOS,BOS,1,31,42,-11,-3,-8,0,-1,21,29,-8,0,-8,0,1
Montreal Canadiens,2013/02/06  vs. BOS,BOS,1,40,37,3,0,-4,7,-4,21,27,-6,2,-7,-1,-5
Los Angeles Kings,2013/02/11  vs. STL,STL,1,32,25,7,3,4,0,3,23,20,3,2,1,0,0
Chicago Blackhawks,2013/02/22  vs. SJS,SJS,1,46,38,8,5,3,0,5,34,25,9,2,7,0,2
Nashville Predators,2013/02/09  vs. MIN,MIN,1,21,35,-14,-15,1,0,-14,15,25,-10,-9,-1,0,-10
Washington Capitals,2013/01/31  vs. TOR,TOR,1,38,55,-17,-2,-19,4,-13,26,42,-16,-6,-12,2,-12
Pittsburgh Penguins,2013/03/14  vs. TOR,TOR,1,47,44,3,-7,0,10,2,30,37,-7,-12,1,4,-9
New York Islanders,2013/02/24  vs. CAR,CAR,1,47,50,-3,-5,2,0,-10,33,34,-1,-5,5,-1,-8
Colorado Avalanche,2013/01/30  vs. VAN,VAN,1,32,48,-16,5,0,-21,-10,26,29,-3,6,0,-9,-5
Philadelphia Flyers,2013/01/22  vs. NJD,NJD,1,33,24,9,0,0,9,8,22,19,3,0,0,3,6
Vancouver Canucks,2013/02/26  vs. PHX,PHX,1,47,24,23,4,0,19,19,33,19,14,3,0,11,14
Washington Capitals,2013/02/21  vs. NJD,NJD,1,22,42,-20,-13,-7,0,-19,13,34,-21,-13,-5,-3,-17
New York Islanders,2013/03/28  vs. PHI,PHI,1,55,49,6,8,-2,0,17,38,38,0,5,-1,-4,11
New Jersey Devils,2013/04/23  vs. MTL,MTL,1,30,22,8,-1,9,0,-1,23,18,5,-2,7,0,-2
Anaheim Ducks,2013/03/04  vs. PHX,PHX,1,38,49,-11,-4,-6,-1,-12,36,37,-1,1,-2,0,-3
Dallas Stars,2013/02/08  vs. ANA,ANA,1,38,33,5,12,-7,0,12,26,25,1,9,-8,0,5
Los Angeles Kings,2013/03/12  vs. PHX,PHX,1,56,41,15,1,0,14,-3,34,32,2,-1,0,3,-5
New Jersey Devils,2013/04/27  vs. NYR,NYR,1,38,28,10,-3,0,13,0,21,24,-3,-3,0,0,-4
St. Louis Blues,2013/04/18  vs. PHX,PHX,1,45,46,-1,1,-2,0,0,35,34,1,-2,3,0,-1
Washington Capitals,2013/03/30  vs. BUF,BUF,1,49,31,18,1,0,17,-1,38,23,15,0,0,15,2
Chicago Blackhawks,2013/02/19  vs. VAN,VAN,1,44,33,11,2,10,-1,3,35,22,13,0,10,3,4
Boston Bruins,2013/01/19  vs. NYR,NYR,1,32,24,8,5,3,0,12,24,22,2,4,-2,0,5
San Jose Sharks,2013/03/05  vs. VAN,VAN,1,31,48,-17,-1,-16,0,-13,25,34,-9,0,-9,0,-9
Pittsburgh Penguins,2013/01/31  vs. NYR,NYR,1,33,32,1,2,-1,0,4,26,25,1,2,-1,0,4
Calgary Flames,2013/03/09  vs. LAK,LAK,1,36,51,-15,-4,0,-11,-9,28,37,-9,-3,0,-6,-5
Tampa Bay Lightning,2013/03/20  vs. TOR,TOR,1,53,49,4,-3,0,7,-4,37,37,0,-3,0,3,-4
Vancouver Canucks,2013/03/03  vs. CGY,CGY,1,46,47,-1,-1,2,-2,1,33,35,-2,-5,3,0,-2
San Jose Sharks,2013/04/23  vs. DAL,DAL,1,66,54,12,1,-3,14,10,43,34,9,0,1,8,9
Washington Capitals,2013/04/02  vs. CAR,CAR,1,29,48,-19,-3,-15,-1,-12,20,35,-15,-5,-9,-1,-14
Edmonton Oilers,2013/02/12  vs. DAL,DAL,1,39,43,-4,-7,5,-2,-2,31,33,-2,-5,7,-4,2
Carolina Hurricanes,2013/03/26  vs. WPG,WPG,1,64,63,1,6,1,-6,1,44,49,-5,4,-1,-8,-1
Toronto Maple Leafs,2013/01/21  vs. BUF,BUF,1,44,27,17,-2,0,19,-1,30,21,9,-3,0,12,-1
Vancouver Canucks,2013/02/01  vs. CHI,CHI,1,25,33,-8,1,-9,0,-6,19,23,-4,0,-4,0,-3
Edmonton Oilers,2013/03/05  vs. CBJ,CBJ,1,41,45,-4,-3,1,-2,-4,30,35,-5,-3,1,-3,-5
New York Rangers,2013/01/23  vs. BOS,BOS,1,38,47,-9,5,-14,0,1,33,29,4,9,-5,0,8
Anaheim Ducks,2013/03/01  vs. MIN,MIN,1,46,44,2,3,-1,0,3,40,30,10,3,7,0,7
Montreal Canadiens,2013/04/11  vs. BUF,BUF,1,44,31,13,6,7,0,10,36,20,16,4,12,0,8
Washington Capitals,2013/02/07  vs. PIT,PIT,1,33,33,0,-3,4,-1,-2,27,29,-2,-3,3,-2,-4
Vancouver Canucks,2013/02/07  vs. MIN,MIN,1,25,28,-3,2,-5,0,2,21,26,-5,0,-5,0,0
Minnesota Wild,2013/03/01  vs. ANA,ANA,1,44,46,-2,-3,0,1,-3,30,40,-10,-3,0,-7,-7
Anaheim Ducks,2013/02/02  vs. LAK,LAK,1,28,54,-26,-11,-15,0,-17,22,41,-19,-10,-9,0,-14
Winnipeg Jets,2013/04/16  vs. TBL,TBL,1,53,45,8,-8,16,0,5,41,32,9,-5,14,0,8
Tampa Bay Lightning,2013/03/18  vs. PHI,PHI,1,47,40,7,14,-7,0,4,37,34,3,9,-6,0,2
Calgary Flames,2013/04/08  vs. COL,COL,1,37,47,-10,-6,-4,0,-4,30,35,-5,0,-4,-1,1
Philadelphia Flyers,2013/01/26  vs. FLA,FLA,1,35,48,-13,3,-16,0,2,27,39,-12,3,-15,0,2
Minnesota Wild,2013/01/19  vs. COL,COL,1,36,43,-7,1,1,-9,-6,31,29,2,1,7,-6,-3
Vancouver Canucks,2013/03/24  vs. COL,COL,1,46,36,10,4,6,0,5,33,26,7,4,3,0,3
St. Louis Blues,2013/02/01  vs. DET,DET,1,30,33,-3,-2,1,-2,-3,21,23,-2,-3,3,-2,-2
Minnesota Wild,2013/03/12  vs. ANA,ANA,1,45,33,12,7,6,-1,12,27,24,3,0,5,-2,2
St. Louis Blues,2013/03/24  vs. CGY,CGY,1,50,30,20,5,0,15,19,38,19,19,4,0,15,16
Detroit Red Wings,2013/01/25  vs. MIN,MIN,1,34,26,8,-1,9,0,0,29,18,11,-1,12,0,3
New Jersey Devils,2013/04/18  vs. PHI,PHI,1,48,32,16,9,7,0,15,34,23,11,2,9,0,8
St. Louis Blues,2013/01/21  vs. NSH,NSH,1,44,26,18,10,0,8,10,36,21,15,9,0,6,10
Edmonton Oilers,2013/03/08  vs. NSH,NSH,1,35,53,-18,-4,0,-14,-7,28,42,-14,-5,0,-9,-7
San Jose Sharks,2013/04/05  vs. CGY,CGY,1,67,34,33,30,1,2,31,51,25,26,22,1,3,24
Florida Panthers,2013/03/30  vs. NJD,NJD,1,41,24,17,8,0,9,13,28,20,8,3,0,5,7
Buffalo Sabres,2013/04/26  vs. NYI,NYI,1,47,34,13,3,10,0,5,32,29,3,-1,4,0,-2
Carolina Hurricanes,2013/04/13  vs. BOS,BOS,1,59,54,5,-2,-2,9,9,47,39,8,1,0,7,11
Buffalo Sabres,2013/04/22  vs. WPG,WPG,1,44,50,-6,-10,0,4,-10,39,45,-6,-8,0,2,-9
Toronto Maple Leafs,2013/03/23  vs. BOS,BOS,1,30,70,-40,1,-41,0,-15,21,43,-22,0,-22,0,-8
New York Islanders,2013/02/19  vs. OTT,OTT,1,52,41,11,3,0,8,5,42,30,12,5,0,7,7
Minnesota Wild,2013/03/14  vs. COL,COL,1,53,49,4,4,0,0,6,40,36,4,3,1,0,7
Nashville Predators,2013/04/02  vs. COL,COL,1,55,42,13,8,0,5,8,43,29,14,10,0,4,10
Pittsburgh Penguins,2013/02/07  vs. WSH,WSH,1,33,33,0,3,1,-4,2,29,27,2,3,2,-3,4
Los Angeles Kings,2013/02/23  vs. COL,COL,1,42,30,12,0,12,0,2,32,27,5,0,5,0,1
Florida Panthers,2013/02/26  vs. PIT,PIT,1,39,49,-10,2,-12,0,1,28,39,-11,2,-13,0,0
Dallas Stars,2013/04/19  vs. STL,STL,1,39,31,8,-1,0,9,1,27,22,5,-1,0,6,1
Los Angeles Kings,2013/03/14  vs. SJS,SJS,1,54,39,15,7,0,8,11,35,29,6,2,0,4,2
Detroit Red Wings,2013/02/24  vs. VAN,VAN,1,34,30,4,6,-3,1,9,27,23,4,3,1,0,6
Boston Bruins,2013/04/27  vs. WSH,WSH,1,52,48,4,1,3,0,6,38,34,4,3,1,0,6
Tampa Bay Lightning,2013/03/16  vs. CAR,CAR,1,41,56,-15,1,-16,0,-4,31,37,-6,1,-7,0,0
Florida Panthers,2013/04/06  vs. WSH,WSH,1,40,42,-2,2,0,-4,2,28,32,-4,0,0,-4,0
Vancouver Canucks,2013/02/24  vs. DET,DET,1,30,34,-4,-6,-1,3,-9,23,27,-4,-3,0,-1,-6
Minnesota Wild,2013/02/09  vs. NSH,NSH,1,35,21,14,15,0,-1,14,25,15,10,9,0,1,10
Philadelphia Flyers,2013/02/05  vs. TBL,TBL,1,49,42,7,2,5,0,12,31,29,2,-1,3,0,4
New York Islanders,2013/02/07  vs. NYR,NYR,1,40,36,4,1,0,3,-6,27,27,0,1,0,-1,-5
Chicago Blackhawks,2013/04/27  vs. STL,STL,1,41,49,-8,3,0,-11,-1,31,34,-3,2,0,-5,1
Minnesota Wild,2013/04/09  vs. CHI,CHI,1,37,44,-7,-9,0,2,-11,28,39,-11,-11,0,0,-12
Chicago Blackhawks,2013/03/14  vs. CBJ,CBJ,1,54,42,12,12,0,0,12,37,30,7,7,0,0,7
Ottawa Senators,2013/03/19  vs. NYI,NYI,1,40,30,10,8,2,0,6,27,23,4,1,4,-1,0
Philadelphia Flyers,2013/03/09  vs. BOS,BOS,1,42,65,-23,-4,0,-19,-5,27,41,-14,1,0,-15,0
Philadelphia Flyers,2013/02/18  vs. NYI,NYI,1,30,39,-9,0,-9,0,0,24,24,0,0,0,0,1
Ottawa Senators,2013/01/19  vs. WPG,WPG,1,51,46,5,0,1,4,2,42,34,8,2,5,1,4
San Jose Sharks,2013/03/30  vs. PHX,PHX,1,71,51,20,7,0,13,5,50,37,13,8,0,5,5
San Jose Sharks,2013/03/09  vs. STL,STL,1,44,50,-6,0,-8,2,-7,26,38,-12,-5,-5,-2,-12
Detroit Red Wings,2013/03/31  vs. CHI,CHI,1,54,46,8,-2,0,10,-3,43,32,11,0,0,11,-1
Detroit Red Wings,2013/04/04  vs. PHX,PHX,1,43,35,8,-4,14,-2,5,34,30,4,-4,6,2,-2
Philadelphia Flyers,2013/03/05  vs. NYR,NYR,1,37,40,-3,-7,0,4,-5,24,30,-6,-10,0,4,-7
Phoenix Coyotes,2013/02/23  vs. EDM,EDM,1,45,50,-5,-1,-4,0,-6,38,38,0,-1,1,0,-1
Calgary Flames,2013/03/26  vs. CHI,CHI,1,32,39,-7,2,0,-9,-7,18,32,-14,-2,0,-12,-12
St. Louis Blues,2013/04/12  vs. CBJ,CBJ,1,52,38,14,0,6,8,5,42,28,14,2,7,5,7
Boston Bruins,2013/03/11  vs. OTT,OTT,1,46,36,10,15,0,-5,6,36,31,5,12,0,-7,2
Anaheim Ducks,2013/02/25  vs. LAK,LAK,1,32,55,-23,-12,-2,-9,-14,24,39,-15,-9,-2,-4,-11
Ottawa Senators,2013/03/23  vs. TBL,TBL,1,43,44,-1,2,-3,0,3,32,31,1,1,0,0,3
Edmonton Oilers,2013/04/06  vs. LAK,LAK,1,32,49,-17,-1,0,-16,-4,24,38,-14,1,0,-15,-1
Calgary Flames,2013/01/31  vs. COL,COL,1,57,30,27,17,8,2,28,40,26,14,7,7,0,15
Detroit Red Wings,2013/03/25  vs. PHX,PHX,1,49,41,8,10,-2,0,14,40,35,5,6,0,-1,9
New York Rangers,2013/01/31  vs. PIT,PIT,1,32,33,-1,-2,0,1,-4,25,26,-1,-2,0,1,-4
New York Rangers,2013/02/07  vs. NYI,NYI,1,36,40,-4,-1,-3,0,6,27,27,0,-1,1,0,5
Detroit Red Wings,2013/04/12  vs. CHI,CHI,1,39,40,-1,1,-3,1,4,27,29,-2,-2,-2,2,1
Montreal Canadiens,2013/02/21  vs. NYI,NYI,1,45,45,0,-5,5,0,0,31,25,6,-5,11,0,2
Boston Bruins,2013/04/25  vs. TBL,TBL,1,40,41,-1,-2,1,0,1,29,29,0,-2,2,0,2
New York Islanders,2013/03/14  vs. TBL,TBL,1,47,40,7,14,-7,0,12,35,28,7,11,-4,0,7
Pittsburgh Penguins,2013/03/17  vs. BOS,BOS,1,39,56,-17,1,-18,0,-2,30,42,-12,-1,-11,0,0
Vancouver Canucks,2013/03/26  vs. CBJ,CBJ,1,59,32,27,27,0,0,27,36,17,19,19,0,0,19
Chicago Blackhawks,2013/03/08  vs. COL,COL,1,52,35,17,4,-2,15,1,35,25,10,-1,2,9,0
Edmonton Oilers,2013/04/19  vs. COL,COL,1,40,53,-13,0,-13,0,-8,29,32,-3,0,-3,0,-4
Colorado Avalanche,2013/01/28  vs. EDM,EDM,1,50,43,7,-6,0,13,-8,41,29,12,-6,0,18,-8
St. Louis Blues,2013/04/07  vs. DET,DET,1,31,43,-12,-4,-8,0,-7,26,33,-7,-4,-3,0,-5
Philadelphia Flyers,2013/04/03  vs. MTL,MTL,1,35,34,1,2,0,-1,-3,29,24,5,5,1,-1,1
Toronto Maple Leafs,2013/04/24  vs. TBL,TBL,1,50,50,0,3,-1,-2,3,39,35,4,6,-2,0,5
Minnesota Wild,2013/03/29  vs. DAL,DAL,1,55,39,16,-2,0,18,10,38,26,12,0,0,12,5
St. Louis Blues,2013/01/19  vs. DET,DET,1,50,26,24,4,20,0,14,40,18,22,2,20,0,10
Winnipeg Jets,2013/04/06  vs. PHI,PHI,1,53,48,5,3,-1,3,7,37,35,2,4,0,-2,3
Anaheim Ducks,2013/02/01  vs. MIN,MIN,1,57,38,19,14,3,2,16,38,28,10,8,3,-1,7
Washington Capitals,2013/04/06  vs. FLA,FLA,1,42,40,2,-2,4,0,-2,32,28,4,0,4,0,0
Colorado Avalanche,2013/04/21  vs. STL,STL,1,53,54,-1,-1,0,0,-8,40,39,1,-3,4,0,-7
Dallas Stars,2013/01/26  vs. STL,STL,1,38,39,-1,4,-7,2,0,28,32,-4,0,-7,3,-6
Los Angeles Kings,2013/01/19  vs. CHI,CHI,1,34,29,5,0,0,5,-4,24,23,1,0,0,1,-3
Boston Bruins,2013/02/17  vs. WPG,WPG,1,59,62,-3,-2,-4,3,1,41,43,-2,2,-8,4,6
Boston Bruins,2013/03/27  vs. MTL,MTL,1,45,33,12,5,-1,8,11,32,26,6,2,-3,7,7
Dallas Stars,2013/03/07  vs. LAK,LAK,1,35,50,-15,-6,-8,-1,-10,28,40,-12,-5,-6,-1,-7
Dallas Stars,2013/02/23  vs. SJS,SJS,1,37,37,0,-8,8,0,-8,30,33,-3,-11,8,0,-11
Philadelphia Flyers,2013/03/18  vs. TBL,TBL,1,40,47,-7,-14,0,7,-4,34,37,-3,-9,0,6,-2
Buffalo Sabres,2013/03/19  vs. MTL,MTL,1,26,71,-45,-1,-44,0,-8,18,51,-33,-2,-31,0,-5
Nashville Predators,2013/03/08  vs. EDM,EDM,1,53,35,18,4,14,0,7,42,28,14,5,9,0,7
Pittsburgh Penguins,2013/03/12  vs. BOS,BOS,1,53,33,20,5,1,14,1,33,23,10,4,1,5,0
Carolina Hurricanes,2013/01/24  vs. BUF,BUF,1,43,44,-1,6,-7,0,8,31,32,-1,1,-2,0,2
Toronto Maple Leafs,2013/02/21  vs. BUF,BUF,1,48,50,-2,-3,-2,3,2,36,36,0,-1,-1,2,3
New York Rangers,2013/04/03  vs. PIT,PIT,1,56,39,17,2,15,0,3,44,31,13,1,12,0,2
Calgary Flames,2013/03/06  vs. SJS,SJS,1,42,50,-8,3,-11,0,4,35,37,-2,2,-4,0,6
Florida Panthers,2013/03/12  vs. TBL,TBL,1,49,27,22,7,0,15,20,38,18,20,9,0,11,20
Edmonton Oilers,2013/02/02  vs. COL,COL,1,38,38,0,1,2,-3,3,32,26,6,1,7,-2,8
Toronto Maple Leafs,2013/03/14  vs. PIT,PIT,1,44,47,-3,7,-10,0,-2,37,30,7,12,-4,-1,9
Columbus Blue Jackets,2013/04/12  vs. STL,STL,1,38,52,-14,0,-8,-6,-5,28,42,-14,-2,-5,-7,-7
Anaheim Ducks,2013/01/29  vs. SJS,SJS,1,46,41,5,-1,0,6,1,32,29,3,-2,2,3,-2
Ottawa Senators,2013/04/20  vs. TOR,TOR,1,77,32,45,21,0,24,22,55,25,30,17,0,13,18
New York Islanders,2013/02/11  vs. CAR,CAR,1,40,47,-7,3,-7,-3,-2,25,33,-8,-2,-2,-4,-2
Buffalo Sabres,2013/02/15  vs. BOS,BOS,1,42,48,-6,1,-1,-6,-9,29,39,-10,3,-3,-10,-13
St. Louis Blues,2013/03/10  vs. ANA,ANA,1,44,27,17,1,11,5,11,37,16,21,2,14,5,15
Los Angeles Kings,2013/02/17  vs. CHI,CHI,1,38,43,-5,-6,0,1,-6,21,34,-13,-5,0,-8,-6
Chicago Blackhawks,2013/01/30  vs. MIN,MIN,1,42,35,7,11,-3,-1,7,36,26,10,10,-1,1,10
Florida Panthers,2013/03/07  vs. WSH,WSH,1,56,40,16,5,0,11,4,37,30,7,5,0,2,3
New York Rangers,2013/02/17  vs. WSH,WSH,1,52,32,20,-1,1,20,19,39,25,14,-4,0,18,14
Ottawa Senators,2013/04/22  vs. PIT,PIT,1,38,14,24,5,0,19,9,27,12,15,4,0,11,6
Washington Capitals,2013/02/26  vs. CAR,CAR,1,61,57,4,4,0,0,9,47,40,7,2,5,0,4
Vancouver Canucks,2013/03/10  vs. MIN,MIN,1,33,36,-3,0,0,-3,4,24,29,-5,0,0,-5,-1
Minnesota Wild,2013/04/01  vs. STL,STL,1,36,46,-10,-9,0,-1,-23,27,30,-3,-6,0,3,-15
Winnipeg Jets,2013/04/04  vs. MTL,MTL,1,55,36,19,2,1,16,3,31,23,8,1,1,6,2
Chicago Blackhawks,2013/01/24  vs. DAL,DAL,1,54,36,18,5,0,13,10,37,29,8,-2,0,10,6
Chicago Blackhawks,2013/03/06  vs. COL,COL,1,46,51,-5,-3,-1,-1,-5,33,30,3,4,1,-2,2
Los Angeles Kings,2013/02/10  vs. DET,DET,1,53,32,21,4,0,17,17,46,27,19,4,0,15,16
Chicago Blackhawks,2013/03/03  vs. DET,DET,1,49,33,16,11,0,5,11,40,26,14,13,0,1,13
Buffalo Sabres,2013/03/07  vs. NJD,NJD,1,38,44,-6,5,-11,0,2,30,36,-6,3,-9,0,0
Vancouver Canucks,2013/03/16  vs. DET,DET,1,43,42,1,1,1,-1,0,35,31,4,7,2,-5,6
Dallas Stars,2013/02/04  vs. COL,COL,1,42,31,11,0,11,0,4,27,25,2,-4,6,0,-4
San Jose Sharks,2013/02/28  vs. DET,DET,1,53,59,-6,-6,0,0,-6,34,39,-5,-5,0,0,-5
Pittsburgh Penguins,2013/03/09  vs. TOR,TOR,1,60,40,20,5,15,0,23,45,27,18,2,16,0,14
Edmonton Oilers,2013/01/30  vs. PHX,PHX,1,42,49,-7,2,-9,0,-3,32,37,-5,4,-9,0,-1
Toronto Maple Leafs,2013/04/27  vs. MTL,MTL,1,30,44,-14,-11,-1,-2,-14,19,30,-11,-6,-1,-4,-8
San Jose Sharks,2013/04/07  vs. DAL,DAL,1,49,52,-3,4,-7,0,5,40,34,6,8,-2,0,11
Pittsburgh Penguins,2013/03/07  vs. PHI,PHI,1,41,38,3,-3,-4,10,0,26,28,-2,-4,-1,3,-5
Winnipeg Jets,2013/03/21  vs. WSH,WSH,1,41,35,6,0,0,6,-1,26,21,5,0,0,5,1
Montreal Canadiens,2013/04/18  vs. TBL,TBL,1,48,53,-5,6,-11,0,1,36,41,-5,7,-12,0,2
Detroit Red Wings,2013/04/24  vs. LAK,LAK,1,58,32,26,23,-3,6,29,47,28,19,17,-2,4,21
Buffalo Sabres,2013/03/12  vs. NYR,NYR,1,39,42,-3,1,-7,3,11,27,30,-3,0,-6,3,7
Dallas Stars,2013/03/12  vs. NSH,NSH,1,59,28,31,5,0,26,2,42,17,25,4,0,21,2
Columbus Blue Jackets,2013/03/19  vs. NSH,NSH,1,37,46,-9,1,-10,0,5,26,39,-13,-1,-12,0,4
New York Rangers,2013/04/01  vs. WPG,WPG,1,52,50,2,-2,2,2,0,38,32,6,0,2,4,5
Dallas Stars,2013/03/25  vs. MIN,MIN,1,40,54,-14,-4,-3,-7,-9,27,44,-17,-8,-4,-5,-14
Edmonton Oilers,2013/01/22  vs. SJS,SJS,1,34,38,-4,-1,0,-3,-3,29,29,0,-1,0,1,-3
New York Rangers,2013/04/23  vs. FLA,FLA,1,56,31,25,13,0,12,20,42,18,24,16,0,8,23
Dallas Stars,2013/03/31  vs. LAK,LAK,1,44,60,-16,-8,0,-8,-27,29,46,-17,-8,0,-9,-23
Tampa Bay Lightning,2013/04/27  vs. FLA,FLA,1,46,49,-3,6,-8,-1,1,34,39,-5,2,-4,-3,-2
Detroit Red Wings,2013/04/27  vs. DAL,DAL,1,61,40,21,13,8,0,14,48,24,24,14,10,0,21
New York Islanders,2013/02/18  vs. PHI,PHI,1,39,30,9,0,0,9,0,24,24,0,0,0,0,-1
Ottawa Senators,2013/02/19  vs. NYI,NYI,1,41,52,-11,-3,-8,0,-5,30,42,-12,-5,-7,0,-7
Detroit Red Wings,2013/04/17  vs. CGY,CGY,1,55,29,26,10,0,16,13,44,21,23,11,0,12,12
Phoenix Coyotes,2013/04/06  vs. COL,COL,1,49,35,14,4,10,0,8,41,26,15,2,13,0,9
Chicago Blackhawks,2013/02/05  vs. SJS,SJS,1,33,40,-7,-11,-2,6,-7,23,31,-8,-10,-2,4,-6
St. Louis Blues,2013/03/19  vs. VAN,VAN,1,49,39,10,0,0,10,-2,36,28,8,4,0,4,2
Winnipeg Jets,2013/01/22  vs. WSH,WSH,1,47,47,0,1,-1,0,2,38,31,7,2,5,0,6
Toronto Maple Leafs,2013/03/20  vs. TBL,TBL,1,49,53,-4,3,-7,0,4,37,37,0,3,-3,0,4
New Jersey Devils,2013/04/10  vs. BOS,BOS,1,29,23,6,0,0,6,-1,27,17,10,0,0,10,-1
Ottawa Senators,2013/02/25  vs. MTL,MTL,1,35,53,-18,-19,1,0,-18,27,44,-17,-17,0,0,-17
Tampa Bay Lightning,2013/04/11  vs. PIT,PIT,1,36,38,-2,5,0,-7,-3,26,30,-4,4,0,-8,-3
New York Islanders,2013/03/21  vs. MTL,MTL,1,41,38,3,0,3,0,2,26,31,-5,-2,2,-5,-2
Los Angeles Kings,2013/04/13  vs. ANA,ANA,1,47,33,14,0,14,0,11,36,27,9,-3,12,0,7
St. Louis Blues,2013/02/19  vs. SJS,SJS,1,36,37,-1,-4,5,-2,1,25,26,-1,-3,5,-3,2
Edmonton Oilers,2013/04/10  vs. PHX,PHX,1,39,51,-12,-4,0,-8,-10,34,38,-4,0,0,-4,-4
Calgary Flames,2013/03/24  vs. STL,STL,1,30,50,-20,-5,-15,0,-19,19,38,-19,-4,-15,0,-16
Philadelphia Flyers,2013/03/15  vs. NJD,NJD,1,23,27,-4,0,-4,0,-4,16,21,-5,-4,-1,0,-5
Florida Panthers,2013/03/05  vs. WPG,WPG,1,41,47,-6,1,-7,0,10,33,41,-8,0,-8,0,5
Winnipeg Jets,2013/03/10  vs. NJD,NJD,1,34,48,-14,-10,0,-4,-11,26,35,-9,-10,0,1,-7
Calgary Flames,2013/04/19  vs. ANA,ANA,1,42,61,-19,-3,-16,0,-4,29,41,-12,-2,-10,0,-1
Philadelphia Flyers,2013/04/13  vs. BUF,BUF,1,39,34,5,1,0,4,1,32,26,6,2,0,4,2
Washington Capitals,2013/04/09  vs. MTL,MTL,1,43,66,-23,-1,-18,-4,-11,35,38,-3,4,-5,-2,0
Colorado Avalanche,2013/01/22  vs. LAK,LAK,1,37,39,-2,-11,2,7,-9,31,27,4,-7,3,8,-4
Nashville Predators,2013/01/22  vs. MIN,MIN,1,31,42,-11,-8,-5,2,-6,24,29,-5,-3,-2,0,-3
Toronto Maple Leafs,2013/04/15  vs. NJD,NJD,1,24,54,-30,-33,3,0,-33,16,36,-20,-22,2,0,-22
Philadelphia Flyers,2013/01/29  vs. NYR,NYR,1,37,42,-5,0,0,-5,-4,26,29,-3,1,0,-4,-2
Phoenix Coyotes,2013/02/26  vs. VAN,VAN,1,24,47,-23,-4,-19,0,-19,19,33,-14,-3,-11,0,-14
Winnipeg Jets,2013/02/05  vs. FLA,FLA,1,47,33,14,5,0,9,14,29,24,5,-1,0,6,5
Columbus Blue Jackets,2013/01/19  vs. NSH,NSH,1,36,49,-13,-7,0,-6,-13,28,40,-12,-8,0,-4,-12
Nashville Predators,2013/04/27  vs. CBJ,CBJ,1,36,58,-22,-1,-17,-4,-7,28,49,-21,-3,-14,-4,-8
Boston Bruins,2013/03/12  vs. PIT,PIT,1,33,53,-20,-5,-14,-1,-1,23,33,-10,-4,-5,-1,0
Washington Capitals,2013/04/16  vs. TOR,TOR,1,46,33,13,4,9,0,9,35,26,9,4,5,0,9
St. Louis Blues,2013/02/15  vs. CGY,CGY,1,38,46,-8,0,-8,0,3,31,31,0,0,0,0,2
Pittsburgh Penguins,2013/03/19  vs. WSH,WSH,1,45,48,-3,-1,-1,-1,-2,35,30,5,2,4,-1,1
Calgary Flames,2013/01/20  vs. SJS,SJS,1,51,41,10,8,-4,6,-1,39,28,11,8,1,2,4
Washington Capitals,2013/03/05  vs. BOS,BOS,1,56,58,-2,1,0,-3,0,39,40,-1,3,0,-4,3
Columbus Blue Jackets,2013/04/18  vs. LAK,LAK,1,34,34,0,-3,0,3,-5,21,26,-5,-2,0,-3,-9
Edmonton Oilers,2013/03/10  vs. CHI,CHI,1,32,53,-21,2,-23,0,4,24,39,-15,1,-16,0,2
Carolina Hurricanes,2013/03/18  vs. NYR,NYR,1,56,59,-3,8,-11,0,-3,40,45,-5,4,-9,0,-5
Columbus Blue Jackets,2013/03/07  vs. VAN,VAN,1,41,51,-10,-1,-9,0,-10,33,41,-8,0,-8,0,-8
Pittsburgh Penguins,2013/04/17  vs. MTL,MTL,1,24,59,-35,-4,-31,0,-4,18,37,-19,0,-19,0,0
San Jose Sharks,2013/02/15  vs. CHI,CHI,1,46,36,10,6,0,4,5,32,30,2,2,0,0,-2
Ottawa Senators,2013/01/21  vs. FLA,FLA,1,40,43,-3,3,-6,0,8,29,30,-1,3,-4,0,3
Phoenix Coyotes,2013/04/15  vs. SJS,SJS,1,57,54,3,-7,0,10,-7,47,43,4,-2,0,6,-2
Pittsburgh Penguins,2013/04/05  vs. NYR,NYR,1,35,65,-30,-20,-10,0,-20,22,49,-27,-15,-12,0,-15
Vancouver Canucks,2013/03/14  vs. NSH,NSH,1,36,37,-1,2,-3,0,2,29,30,-1,0,-1,0,1
Boston Bruins,2013/02/24  vs. FLA,FLA,1,49,51,-2,-4,2,0,0,39,37,2,-3,5,0,1
Ottawa Senators,2013/04/05  vs. BUF,BUF,1,45,38,7,4,2,1,7,35,32,3,0,2,1,2
Ottawa Senators,2013/04/27  vs. PHI,PHI,1,56,41,15,4,0,11,12,44,32,12,4,0,8,10
Anaheim Ducks,2013/01/21  vs. CGY,CGY,1,42,48,-6,-14,8,0,-15,32,34,-2,-12,10,0,-12
Toronto Maple Leafs,2013/01/23  vs. PIT,PIT,1,29,40,-11,-10,-5,4,-5,19,31,-12,-11,-4,3,-7
Florida Panthers,2013/02/21  vs. PHI,PHI,1,39,63,-24,1,-25,0,2,29,43,-14,1,-15,0,2
Tampa Bay Lightning,2013/01/25  vs. OTT,OTT,1,48,53,-5,-4,-2,1,0,36,38,-2,-2,1,-1,0
Boston Bruins,2013/01/25  vs. NYI,NYI,1,50,29,21,10,13,-2,16,33,20,13,4,11,-2,10
Carolina Hurricanes,2013/02/28  vs. PIT,PIT,1,37,45,-8,0,-7,-1,3,28,33,-5,1,-5,-1,4
Detroit Red Wings,2013/03/24  vs. ANA,ANA,1,27,48,-21,3,-24,0,1,19,38,-19,0,-19,0,-1
Nashville Predators,2013/03/12  vs. DAL,DAL,1,28,59,-31,-5,-26,0,-2,17,42,-25,-4,-21,0,-2
Pittsburgh Penguins,2013/04/27  vs. CAR,CAR,1,51,49,2,-2,4,0,-3,43,36,7,-1,8,0,1
New Jersey Devils,2013/02/15  vs. PHI,PHI,1,36,44,-8,-2,-5,-1,-10,28,36,-8,-3,-2,-3,-8
Buffalo Sabres,2013/04/11  vs. MTL,MTL,1,31,44,-13,-6,0,-7,-10,20,36,-16,-4,0,-12,-8
New York Rangers,2013/03/12  vs. BUF,BUF,1,42,39,3,-1,-3,7,-11,30,27,3,0,-3,6,-7
Florida Panthers,2013/03/24  vs. NYI,NYI,1,48,44,4,0,0,4,6,32,35,-3,-1,0,-2,3
Buffalo Sabres,2013/01/20  vs. PHI,PHI,1,40,25,15,2,8,5,12,28,24,4,-5,5,4,1
Washington Capitals,2013/03/24  vs. NYR,NYR,1,49,41,8,-3,11,0,-4,30,33,-3,-8,5,0,-11
Los Angeles Kings,2013/03/31  vs. DAL,DAL,1,60,44,16,8,8,0,27,46,29,17,8,9,0,23
Tampa Bay Lightning,2013/03/04  vs. PIT,PIT,1,51,42,9,13,1,-5,12,38,29,9,11,4,-6,12
Toronto Maple Leafs,2013/02/02  vs. BOS,BOS,1,44,52,-8,-3,0,-5,-10,25,41,-16,-2,0,-14,-13
Buffalo Sabres,2013/01/21  vs. TOR,TOR,1,27,44,-17,2,-19,0,1,21,30,-9,3,-12,0,1
Edmonton Oilers,2013/01/24  vs. LAK,LAK,1,24,34,-10,-9,0,-1,-6,17,24,-7,-6,0,-1,-4
New Jersey Devils,2013/03/19  vs. NYR,NYR,1,44,33,11,6,0,5,7,33,29,4,3,0,1,4
Pittsburgh Penguins,2013/03/16  vs. NYR,NYR,1,50,39,11,1,10,0,5,37,26,11,1,10,0,9
Calgary Flames,2013/02/09  vs. VAN,VAN,1,43,44,-1,2,-6,3,-6,36,36,0,2,-5,3,-3
St. Louis Blues,2013/04/27  vs. CHI,CHI,1,49,41,8,-3,11,0,1,34,31,3,-2,5,0,-1
Minnesota Wild,2013/03/10  vs. VAN,VAN,1,36,33,3,0,3,0,-4,29,24,5,0,5,0,1
Carolina Hurricanes,2013/02/23  vs. TBL,TBL,1,56,54,2,-2,0,4,9,40,43,-3,-3,0,0,3
Minnesota Wild,2013/02/11  vs. CGY,CGY,1,31,40,-9,-17,8,0,-13,17,27,-10,-16,6,0,-13
New Jersey Devils,2013/03/30  vs. FLA,FLA,1,24,41,-17,-8,-9,0,-13,20,28,-8,-3,-5,0,-7
Columbus Blue Jackets,2013/03/23  vs. NSH,NSH,1,37,38,-1,-6,0,5,-9,24,28,-4,-4,0,0,-6
Philadelphia Flyers,2013/02/16  vs. MTL,MTL,1,30,39,-9,2,0,-11,-7,21,27,-6,2,0,-8,-5
Los Angeles Kings,2013/04/16  vs. SJS,SJS,1,43,51,-8,-5,0,-3,-5,36,37,-1,1,0,-2,2
Montreal Canadiens,2013/03/05  vs. NYI,NYI,1,46,34,12,-1,7,6,2,32,22,10,1,4,5,2
Minnesota Wild,2013/03/30  vs. LAK,LAK,1,39,44,-5,-2,0,-3,-9,31,36,-5,-3,0,-2,-7
Calgary Flames,2013/01/23  vs. VAN,VAN,1,38,58,-20,-19,0,-1,-20,29,44,-15,-15,0,0,-15
Columbus Blue Jackets,2013/02/18  vs. ANA,ANA,1,58,41,17,5,1,11,8,33,33,0,2,-2,0,-5
Detroit Red Wings,2013/04/25  vs. NSH,NSH,1,50,25,25,10,6,9,19,41,22,19,7,5,7,14
Buffalo Sabres,2013/04/14  vs. TBL,TBL,1,33,47,-14,1,-15,0,-5,25,40,-15,2,-17,0,-7
Anaheim Ducks,2013/04/27  vs. PHX,PHX,1,60,50,10,5,0,5,-3,49,36,13,9,0,4,1
Vancouver Canucks,2013/02/09  vs. CGY,CGY,1,44,43,1,-2,-3,6,6,36,36,0,-2,-3,5,3
Winnipeg Jets,2013/03/17  vs. OTT,OTT,1,35,54,-19,-2,0,-17,-8,28,46,-18,0,0,-18,-3
Tampa Bay Lightning,2013/03/07  vs. WPG,WPG,1,40,46,-6,-2,0,-4,-9,29,34,-5,-2,0,-3,-9
Los Angeles Kings,2013/03/18  vs. PHX,PHX,1,36,41,-5,1,-6,0,-5,29,33,-4,1,-5,0,-3
San Jose Sharks,2013/03/20  vs. EDM,EDM,1,54,37,17,20,0,-3,19,41,28,13,16,0,-3,14
New York Islanders,2013/02/05  vs. PIT,PIT,1,38,35,3,1,0,2,5,27,27,0,0,0,0,4
Florida Panthers,2013/04/23  vs. NYR,NYR,1,31,56,-25,-13,-12,0,-20,18,42,-24,-16,-8,0,-23
Nashville Predators,2013/02/05  vs. STL,STL,1,28,37,-9,1,-10,0,1,23,25,-2,1,-3,0,1
New York Rangers,2013/04/21  vs. NJD,NJD,1,28,42,-14,1,-15,0,3,23,33,-10,1,-11,0,1
Boston Bruins,2013/04/20  vs. PIT,PIT,1,56,21,35,20,6,9,26,42,17,25,14,4,7,18
Tampa Bay Lightning,2013/02/19  vs. TOR,TOR,1,33,46,-13,-9,-4,0,-13,24,32,-8,-9,1,0,-6
Tampa Bay Lightning,2013/03/12  vs. FLA,FLA,1,27,49,-22,-7,-15,0,-20,18,38,-20,-9,-11,0,-20
New York Rangers,2013/04/05  vs. PIT,PIT,1,65,35,30,20,0,10,20,49,22,27,15,0,12,15
Dallas Stars,2013/04/25  vs. CBJ,CBJ,1,64,38,26,5,0,21,15,41,33,8,0,0,8,1
Vancouver Canucks,2013/02/12  vs. MIN,MIN,1,45,23,22,8,14,0,17,35,19,16,7,9,0,13
Minnesota Wild,2013/02/17  vs. DET,DET,1,38,47,-9,1,-3,-7,-8,32,37,-5,1,-2,-4,-4
New York Rangers,2013/02/19  vs. MTL,MTL,1,46,46,0,-1,-2,3,-3,31,26,5,2,1,2,3
Pittsburgh Penguins,2013/02/03  vs. WSH,WSH,1,39,53,-14,-3,-11,0,-7,29,34,-5,-4,-1,0,-3
Ottawa Senators,2013/04/12  vs. NJD,NJD,1,23,44,-21,-8,-13,0,-5,15,35,-20,-8,-12,0,-6
Nashville Predators,2013/03/02  vs. SJS,SJS,1,44,59,-15,-11,0,-4,-7,22,43,-21,-10,0,-11,-13
Dallas Stars,2013/02/15  vs. VAN,VAN,1,29,37,-8,-3,-3,-2,1,22,27,-5,1,-2,-4,2
Edmonton Oilers,2013/03/15  vs. DET,DET,1,40,38,2,1,1,0,5,33,25,8,5,3,0,11
Washington Capitals,2013/04/18  vs. OTT,OTT,1,31,59,-28,-17,0,-11,-25,23,46,-23,-13,0,-10,-23
Florida Panthers,2013/03/19  vs. CAR,CAR,1,57,61,-4,3,-7,0,3,47,45,2,7,-5,0,7
Buffalo Sabres,2013/03/21  vs. TOR,TOR,1,42,37,5,-3,5,3,-3,33,31,2,-5,3,4,-3
Phoenix Coyotes,2013/01/26  vs. LAK,LAK,1,38,44,-6,-2,0,-4,-9,31,37,-6,1,0,-7,-6
Carolina Hurricanes,2013/04/01  vs. MTL,MTL,1,44,44,0,-6,3,3,0,30,33,-3,-3,1,-1,-1
Washington Capitals,2013/03/02  vs. WPG,WPG,1,41,43,-2,-1,-1,0,-1,33,31,2,-2,4,0,0
Philadelphia Flyers,2013/02/07  vs. FLA,FLA,1,38,37,1,4,-2,-1,6,23,27,-4,3,-6,-1,-1
Calgary Flames,2013/03/18  vs. DAL,DAL,1,38,44,-6,-16,0,10,-18,22,32,-10,-10,0,0,-11
Boston Bruins,2013/02/15  vs. BUF,BUF,1,48,42,6,-1,6,1,9,39,29,10,-3,10,3,13
Boston Bruins,2013/04/10  vs. NJD,NJD,1,23,29,-6,0,-6,0,1,17,27,-10,0,-10,0,1
Chicago Blackhawks,2013/03/16  vs. DAL,DAL,1,51,30,21,1,20,0,7,39,22,17,-1,18,0,4
Calgary Flames,2013/04/12  vs. PHX,PHX,1,38,54,-16,-17,-5,6,-13,29,42,-13,-11,-7,5,-8
Montreal Canadiens,2013/04/04  vs. WPG,WPG,1,36,55,-19,-2,-16,-1,-3,23,31,-8,-1,-6,-1,-2
Montreal Canadiens,2013/04/09  vs. WSH,WSH,1,66,43,23,1,4,18,11,38,35,3,-4,2,5,0
Toronto Maple Leafs,2013/01/26  vs. NYR,NYR,1,29,53,-24,-3,-12,-9,-11,20,42,-22,-4,-11,-7,-11
Philadelphia Flyers,2013/03/26  vs. NYR,NYR,1,55,57,-2,-6,0,4,-9,36,40,-4,-2,0,-2,-7
Los Angeles Kings,2013/03/04  vs. NSH,NSH,1,42,29,13,5,8,0,8,30,24,6,3,3,0,3
Phoenix Coyotes,2013/03/09  vs. DAL,DAL,1,42,43,-1,5,-6,0,-1,32,23,9,6,3,0,7
New York Rangers,2013/03/03  vs. BUF,BUF,1,50,32,18,15,0,3,15,35,22,13,7,0,6,8
Edmonton Oilers,2013/01/20  vs. VAN,VAN,1,39,40,-1,0,0,-1,2,31,28,3,1,0,2,7
Anaheim Ducks,2013/02/12  vs. CHI,CHI,1,34,31,3,0,0,3,-3,22,26,-4,-5,1,0,-6
Carolina Hurricanes,2013/03/02  vs. FLA,FLA,1,43,44,-1,1,-2,0,2,33,29,4,2,2,0,4
Calgary Flames,2013/04/21  vs. MIN,MIN,1,39,53,-14,-7,-7,0,-9,27,40,-13,-8,-5,0,-9
Minnesota Wild,2013/04/23  vs. LAK,LAK,1,41,42,-1,5,-6,0,5,36,33,3,4,-1,0,4
New York Rangers,2013/02/28  vs. TBL,TBL,1,53,38,15,12,3,0,14,34,26,8,9,-1,0,10
Boston Bruins,2013/04/02  vs. OTT,OTT,1,62,61,1,2,-1,0,3,55,45,10,4,6,0,11
Tampa Bay Lightning,2013/03/02  vs. BOS,BOS,1,22,35,-13,-10,-3,0,-10,15,28,-13,-12,-1,0,-12
New Jersey Devils,2013/03/10  vs. WPG,WPG,1,48,34,14,10,4,0,11,35,26,9,10,-1,0,7
Pittsburgh Penguins,2013/01/25  vs. WPG,WPG,1,65,50,15,9,1,5,14,48,41,7,9,-1,-1,11
Calgary Flames,2013/04/25  vs. STL,STL,1,27,36,-9,-5,0,-4,-4,20,25,-5,-2,0,-3,-2
Edmonton Oilers,2013/04/22  vs. ANA,ANA,1,51,45,6,-3,0,9,-2,31,34,-3,-2,0,-1,-1
Chicago Blackhawks,2013/04/12  vs. DET,DET,1,40,39,1,-1,-1,3,-4,29,27,2,2,-2,2,-1
Vancouver Canucks,2013/03/30  vs. EDM,EDM,1,39,43,-4,0,0,-4,-1,26,35,-9,0,0,-9,-1
Los Angeles Kings,2013/02/20  vs. CGY,CGY,1,58,31,27,9,18,0,27,40,24,16,5,11,0,15
Nashville Predators,2013/03/28  vs. PHX,PHX,1,47,40,7,0,0,7,-3,42,34,8,1,0,7,-2
Nashville Predators,2013/02/14  vs. PHX,PHX,1,49,39,10,7,3,0,7,34,24,10,10,0,0,10
San Jose Sharks,2013/02/12  vs. NSH,NSH,1,37,34,3,3,0,0,3,25,24,1,1,0,0,1
New Jersey Devils,2013/04/21  vs. NYR,NYR,1,42,28,14,-1,0,15,-3,33,23,10,-1,0,11,-1
New York Islanders,2013/01/27  vs. WPG,WPG,1,59,59,0,-4,-7,11,6,43,47,-4,-2,-6,4,0
St. Louis Blues,2013/04/04  vs. CHI,CHI,1,33,45,-12,0,-8,-4,-13,24,39,-15,-5,-5,-5,-17
Colorado Avalanche,2013/04/23  vs. STL,STL,1,29,52,-23,0,0,-23,-6,19,40,-21,2,0,-23,-5
San Jose Sharks,2013/03/16  vs. LAK,LAK,1,52,52,0,-3,0,3,-8,33,38,-5,-2,0,-3,-1
Winnipeg Jets,2013/03/28  vs. PIT,PIT,1,39,68,-29,-9,0,-20,-9,29,54,-25,-6,0,-19,-7
Washington Capitals,2013/04/11  vs. CAR,CAR,1,48,59,-11,-1,-13,3,-7,38,42,-4,0,-9,5,-1
Nashville Predators,2013/02/23  vs. DET,DET,1,54,35,19,3,0,16,8,45,29,16,2,0,14,10
Montreal Canadiens,2013/04/03  vs. PHI,PHI,1,34,35,-1,-2,1,0,3,24,29,-5,-5,1,-1,-1
Boston Bruins,2013/02/28  vs. OTT,OTT,1,52,49,3,-6,9,0,3,40,35,5,-2,7,0,5
New Jersey Devils,2013/01/27  vs. MTL,MTL,1,28,45,-17,0,0,-17,-10,24,34,-10,1,0,-11,-4
Buffalo Sabres,2013/03/03  vs. NYR,NYR,1,32,50,-18,-15,-3,0,-15,22,35,-13,-7,-6,0,-8
Washington Capitals,2013/01/27  vs. BUF,BUF,1,37,44,-7,-3,1,-5,-7,29,30,-1,3,0,-4,-3
Chicago Blackhawks,2013/03/26  vs. CGY,CGY,1,39,32,7,-2,9,0,7,32,18,14,2,12,0,12
Chicago Blackhawks,2013/04/24  vs. EDM,EDM,1,46,35,11,-3,14,0,4,38,26,12,-2,14,0,4
Washington Capitals,2013/04/20  vs. MTL,MTL,1,43,48,-5,-2,-3,0,1,27,33,-6,-5,-1,0,-2
Los Angeles Kings,2013/02/05  vs. CBJ,CBJ,1,42,26,16,14,3,-1,16,32,19,13,8,4,1,13
Calgary Flames,2013/02/18  vs. PHX,PHX,1,47,68,-21,-1,0,-20,-14,37,52,-15,-1,0,-14,-8
St. Louis Blues,2013/03/05  vs. LAK,LAK,1,21,38,-17,-11,-1,-5,-8,16,28,-12,-4,-3,-5,-2
Minnesota Wild,2013/02/07  vs. VAN,VAN,1,28,25,3,-2,0,5,-2,26,21,5,0,0,5,0
Florida Panthers,2013/04/20  vs. NJD,NJD,1,18,42,-24,-6,-2,-16,-10,13,36,-23,-6,-2,-15,-8
New York Rangers,2013/03/14  vs. WPG,WPG,1,63,51,12,12,0,0,22,43,34,9,4,0,5,16
San Jose Sharks,2013/04/03  vs. MIN,MIN,1,42,53,-11,-3,-8,0,-6,33,33,0,0,0,0,0
Carolina Hurricanes,2013/03/16  vs. TBL,TBL,1,56,41,15,-1,0,16,4,37,31,6,-1,0,7,0
Philadelphia Flyers,2013/01/27  vs. TBL,TBL,1,48,31,17,0,-1,18,-2,29,25,4,-1,-1,6,-3
Tampa Bay Lightning,2013/03/29  vs. NJD,NJD,1,33,33,0,-7,0,7,-8,26,28,-2,-5,0,3,-5
Calgary Flames,2013/02/20  vs. LAK,LAK,1,31,58,-27,-9,0,-18,-27,24,40,-16,-5,0,-11,-15
St. Louis Blues,2013/01/26  vs. DAL,DAL,1,39,38,1,-4,-2,7,0,32,28,4,0,-3,7,6
Vancouver Canucks,2013/03/05  vs. SJS,SJS,1,48,31,17,1,0,16,13,34,25,9,0,0,9,9
Vancouver Canucks,2013/04/08  vs. PHX,PHX,1,51,38,13,7,6,0,17,41,30,11,4,7,0,12
Winnipeg Jets,2013/04/09  vs. BUF,BUF,1,50,36,14,16,-2,0,18,36,32,4,7,-3,0,9
New Jersey Devils,2013/02/28  vs. WPG,WPG,1,47,34,13,10,0,3,9,30,23,7,5,0,2,3
Winnipeg Jets,2013/01/31  vs. FLA,FLA,1,39,40,-1,-10,3,6,-9,36,28,8,-1,3,6,2
Vancouver Canucks,2013/01/28  vs. LAK,LAK,1,25,47,-22,-3,-19,0,-6,20,32,-12,0,-12,0,-1
Winnipeg Jets,2013/03/22  vs. WSH,WSH,1,46,25,21,6,0,15,13,34,19,15,6,0,9,10
Tampa Bay Lightning,2013/04/02  vs. FLA,FLA,1,55,39,16,11,0,5,7,46,30,16,8,0,8,7
Colorado Avalanche,2013/04/08  vs. CGY,CGY,1,47,37,10,6,0,4,4,35,30,5,0,1,4,-1
New Jersey Devils,2013/02/07  vs. TBL,TBL,1,32,20,12,12,0,0,14,27,15,12,9,3,0,13
Phoenix Coyotes,2013/01/23  vs. CBJ,CBJ,1,58,38,20,7,14,-1,12,46,23,23,13,11,-1,17
Vancouver Canucks,2013/02/04  vs. EDM,EDM,1,50,39,11,1,0,10,9,32,24,8,0,0,8,4
Dallas Stars,2013/04/05  vs. ANA,ANA,1,30,44,-14,-1,-13,0,2,24,31,-7,1,-8,0,3
Montreal Canadiens,2013/03/10  vs. FLA,FLA,1,42,30,12,4,8,0,6,38,22,16,3,13,0,6
San Jose Sharks,2013/01/22  vs. EDM,EDM,1,38,34,4,1,3,0,3,29,29,0,1,-1,0,3
Edmonton Oilers,2013/02/10  vs. CBJ,CBJ,1,18,35,-17,-9,-8,0,-13,14,25,-11,-4,-7,0,-6
Philadelphia Flyers,2013/03/30  vs. BOS,BOS,1,35,60,-25,-6,-19,0,-7,23,45,-22,-7,-15,0,-8
Boston Bruins,2013/04/06  vs. MTL,MTL,1,63,51,12,-3,0,15,4,40,41,-1,-5,0,4,-3
Chicago Blackhawks,2013/01/19  vs. LAK,LAK,1,29,34,-5,0,-5,0,4,23,24,-1,0,-1,0,3
Detroit Red Wings,2013/03/05  vs. COL,COL,1,44,49,-5,-10,5,0,-9,36,38,-2,-3,1,0,-1
Calgary Flames,2013/04/17  vs. DET,DET,1,29,55,-26,-10,-16,0,-13,21,44,-23,-11,-12,0,-12
Phoenix Coyotes,2013/03/30  vs. SJS,SJS,1,51,71,-20,-7,-13,0,-5,37,50,-13,-8,-5,0,-5
Chicago Blackhawks,2013/02/17  vs. LAK,LAK,1,43,38,5,6,-1,0,6,34,21,13,5,8,0,6
Winnipeg Jets,2013/01/21  vs. BOS,BOS,1,51,48,3,1,2,0,3,34,34,0,-3,3,0,0
Washington Capitals,2013/02/05  vs. TOR,TOR,1,56,35,21,2,0,19,13,36,27,9,2,0,7,7
Anaheim Ducks,2013/03/22  vs. DET,DET,1,44,46,-2,-5,2,1,-1,32,32,0,-1,2,-1,1
Vancouver Canucks,2013/04/16  vs. STL,STL,1,33,54,-21,-16,-5,0,-16,24,41,-17,-14,-3,0,-14
Nashville Predators,2013/03/23  vs. CBJ,CBJ,1,38,37,1,6,-5,0,9,28,24,4,4,0,0,6
Phoenix Coyotes,2013/03/14  vs. STL,STL,1,43,42,1,-5,0,6,-1,31,33,-2,-7,0,5,-3
Washington Capitals,2013/03/16  vs. BOS,BOS,1,44,46,-2,-1,0,-1,-2,35,39,-4,0,0,-4,-1
San Jose Sharks,2013/01/31  vs. EDM,EDM,1,46,36,10,6,4,0,10,32,26,6,2,4,0,5
Anaheim Ducks,2013/04/22  vs. EDM,EDM,1,45,51,-6,3,-9,0,2,34,31,3,2,1,0,1
Ottawa Senators,2013/03/16  vs. BUF,BUF,1,45,36,9,-4,8,5,1,34,27,7,-3,3,7,3
New York Rangers,2013/02/12  vs. BOS,BOS,1,30,45,-15,-5,-10,0,-9,23,26,-3,-5,2,0,-5
Columbus Blue Jackets,2013/02/05  vs. LAK,LAK,1,26,42,-16,-14,1,-3,-16,19,32,-13,-8,-1,-4,-13
Ottawa Senators,2013/03/21  vs. BOS,BOS,1,54,52,2,5,-2,-1,3,37,39,-2,-2,1,-1,-1
Calgary Flames,2013/01/21  vs. ANA,ANA,1,48,42,6,14,0,-8,15,34,32,2,12,0,-10,12
Tampa Bay Lightning,2013/04/07  vs. WSH,WSH,1,48,52,-4,-4,-3,3,-9,33,42,-9,-3,-6,0,-11
Minnesota Wild,2013/02/26  vs. CGY,CGY,1,31,14,17,-1,0,18,12,20,11,9,-2,0,11,6
Calgary Flames,2013/04/10  vs. VAN,VAN,1,52,43,9,13,-3,-1,10,44,29,15,17,-2,0,15
Pittsburgh Penguins,2013/02/17  vs. BUF,BUF,1,44,42,2,-1,1,2,1,35,30,5,1,2,2,2
Phoenix Coyotes,2013/03/25  vs. DET,DET,1,41,49,-8,-10,0,2,-14,35,40,-5,-6,1,0,-9
New York Islanders,2013/03/09  vs. WSH,WSH,1,44,41,3,-9,12,0,0,35,27,8,-8,16,0,4
Phoenix Coyotes,2013/01/19  vs. DAL,DAL,1,49,49,0,1,-1,0,-5,37,37,0,0,0,0,-3
Columbus Blue Jackets,2013/01/24  vs. COL,COL,1,46,36,10,0,0,10,-4,27,31,-4,0,0,-4,-6
New Jersey Devils,2013/04/15  vs. TOR,TOR,1,54,24,30,33,0,-3,33,36,16,20,22,0,-2,22
Anaheim Ducks,2013/04/05  vs. DAL,DAL,1,44,30,14,1,0,13,-2,31,24,7,-1,0,8,-3
Calgary Flames,2013/02/28  vs. COL,COL,1,38,47,-9,-2,-7,0,-4,26,33,-7,-2,-4,-1,-4
Calgary Flames,2013/04/23  vs. NSH,NSH,1,32,60,-28,-19,2,-11,-17,26,44,-18,-15,3,-6,-12
Columbus Blue Jackets,2013/01/21  vs. DET,DET,1,23,37,-14,-17,0,3,-16,18,26,-8,-12,0,4,-9
Edmonton Oilers,2013/01/28  vs. COL,COL,1,43,50,-7,6,-13,0,8,29,41,-12,6,-18,0,8
San Jose Sharks,2013/03/14  vs. LAK,LAK,1,39,54,-15,-7,-8,0,-11,29,35,-6,-2,-4,0,-2
Winnipeg Jets,2013/04/01  vs. NYR,NYR,1,50,52,-2,2,-2,-2,0,32,38,-6,0,-4,-2,-5
New Jersey Devils,2013/03/04  vs. TOR,TOR,1,58,35,23,10,4,9,24,43,24,19,12,3,4,23
Montreal Canadiens,2013/04/13  vs. TOR,TOR,1,61,35,26,2,0,24,9,47,27,20,0,0,20,8
San Jose Sharks,2013/02/19  vs. STL,STL,1,37,36,1,4,2,-5,-1,26,25,1,3,3,-5,-2
Dallas Stars,2013/02/28  vs. EDM,EDM,1,49,34,15,-1,0,16,11,34,27,7,-1,0,8,10
Columbus Blue Jackets,2013/01/29  vs. MIN,MIN,1,39,35,4,9,0,-5,1,28,28,0,5,0,-5,-4
Buffalo Sabres,2013/02/21  vs. TOR,TOR,1,50,48,2,3,-3,2,-2,36,36,0,1,-2,1,-3
Carolina Hurricanes,2013/02/11  vs. NYI,NYI,1,47,40,7,-3,3,7,2,33,25,8,2,4,2,2
Phoenix Coyotes,2013/04/10  vs. EDM,EDM,1,51,39,12,4,8,0,10,38,34,4,0,4,0,4
New York Islanders,2013/03/26  vs. WSH,WSH,1,36,56,-20,-12,-8,0,-15,27,36,-9,-9,0,0,-8
Carolina Hurricanes,2013/04/11  vs. WSH,WSH,1,59,48,11,1,-3,13,7,42,38,4,0,-5,9,1
Minnesota Wild,2013/04/16  vs. EDM,EDM,1,37,35,2,2,0,0,1,28,23,5,3,2,0,1
Montreal Canadiens,2013/01/22  vs. FLA,FLA,1,35,27,8,4,4,0,15,24,20,4,4,0,0,10
Toronto Maple Leafs,2013/04/04  vs. PHI,PHI,1,59,42,17,5,1,11,7,41,33,8,4,1,3,5
Detroit Red Wings,2013/03/22  vs. ANA,ANA,1,46,44,2,5,-1,-2,1,32,32,0,1,1,-2,-1
Tampa Bay Lightning,2013/03/24  vs. WPG,WPG,1,38,40,-2,5,0,-7,5,29,27,2,5,0,-3,4
Ottawa Senators,2013/02/28  vs. BOS,BOS,1,49,52,-3,6,0,-9,-3,35,40,-5,2,0,-7,-5
Tampa Bay Lightning,2013/02/23  vs. CAR,CAR,1,54,56,-2,2,-4,0,-9,43,40,3,3,0,0,-3
Ottawa Senators,2013/01/27  vs. PIT,PIT,1,59,36,23,15,0,8,23,39,26,13,11,0,2,13
Buffalo Sabres,2013/04/09  vs. WPG,WPG,1,36,50,-14,-16,0,2,-18,32,36,-4,-7,0,3,-9
Anaheim Ducks,2013/02/16  vs. NSH,NSH,1,41,47,-6,-2,0,-4,-6,27,34,-7,-5,0,-2,-7
Buffalo Sabres,2013/01/24  vs. CAR,CAR,1,44,43,1,-6,0,7,-8,32,31,1,-1,0,2,-2
Florida Panthers,2013/01/19  vs. CAR,CAR,1,23,59,-36,-4,-32,0,-6,16,49,-33,-3,-30,0,-5
St. Louis Blues,2013/03/09  vs. SJS,SJS,1,50,44,6,0,-2,8,7,38,26,12,5,2,5,12
Colorado Avalanche,2013/03/06  vs. CHI,CHI,1,51,46,5,3,1,1,5,30,33,-3,-4,2,-1,-2
Chicago Blackhawks,2013/03/18  vs. COL,COL,1,54,38,16,-1,17,0,3,38,24,14,-2,16,0,2
Detroit Red Wings,2013/03/13  vs. CGY,CGY,1,64,33,31,16,-2,17,25,48,28,20,14,-2,8,16
Anaheim Ducks,2013/04/17  vs. CBJ,CBJ,1,37,43,-6,1,-7,0,-4,31,29,2,8,-6,0,4
Florida Panthers,2013/03/02  vs. CAR,CAR,1,44,43,1,-1,0,2,-2,29,33,-4,-2,0,-2,-4
Buffalo Sabres,2013/04/17  vs. BOS,BOS,1,26,61,-35,-4,0,-31,-26,21,49,-28,-6,0,-22,-22
Tampa Bay Lightning,2013/04/06  vs. NYI,NYI,1,50,50,0,-4,0,4,2,27,33,-6,-3,0,-3,-2
Vancouver Canucks,2013/03/07  vs. CBJ,CBJ,1,51,41,10,1,0,9,10,41,33,8,0,0,8,8
Pittsburgh Penguins,2013/03/24  vs. PHI,PHI,1,57,49,8,2,0,6,4,42,36,6,5,0,1,6
Minnesota Wild,2013/01/27  vs. STL,STL,1,29,44,-15,-4,-8,-3,-4,21,34,-13,-4,-6,-3,-4
Washington Capitals,2013/02/03  vs. PIT,PIT,1,53,39,14,3,0,11,7,34,29,5,4,0,1,3
St. Louis Blues,2013/04/21  vs. COL,COL,1,54,53,1,1,0,0,8,39,40,-1,3,0,-4,7
Edmonton Oilers,2013/02/06  vs. DAL,DAL,1,40,49,-9,-12,-1,4,-13,33,33,0,-6,2,4,-4
New York Islanders,2013/01/19  vs. NJD,NJD,1,31,45,-14,-8,0,-6,-9,22,32,-10,-3,0,-7,-5
Chicago Blackhawks,2013/04/15  vs. DAL,DAL,1,43,27,16,11,5,0,16,30,18,12,5,7,0,13
Vancouver Canucks,2013/02/17  vs. STL,STL,1,46,35,11,5,4,2,9,31,25,6,6,-1,1,5
New York Islanders,2013/02/26  vs. BOS,BOS,1,50,44,6,-5,0,11,-7,38,33,5,-3,0,8,-3
Dallas Stars,2013/02/26  vs. CBJ,CBJ,1,52,27,25,13,12,0,25,40,21,19,11,8,0,18
New York Islanders,2013/02/03  vs. NJD,NJD,1,25,36,-11,-10,0,-1,-10,16,27,-11,-10,0,-1,-10
Chicago Blackhawks,2013/03/25  vs. LAK,LAK,1,31,41,-10,-9,2,-3,-11,24,36,-12,-11,1,-2,-12
Pittsburgh Penguins,2013/02/22  vs. FLA,FLA,1,47,36,11,9,3,-1,8,38,29,9,9,1,-1,8
Los Angeles Kings,2013/03/11  vs. CGY,CGY,1,37,40,-3,-5,2,0,-3,30,29,1,-6,7,0,-4
St. Louis Blues,2013/01/22  vs. CHI,CHI,1,49,36,13,-2,0,15,3,33,29,4,-3,0,7,1
Toronto Maple Leafs,2013/03/07  vs. BOS,BOS,1,38,39,-1,-3,0,2,0,30,31,-1,1,0,-2,4
Winnipeg Jets,2013/03/14  vs. NYR,NYR,1,51,63,-12,-12,0,0,-22,34,43,-9,-4,-5,0,-16
Florida Panthers,2013/02/14  vs. MTL,MTL,1,39,37,2,2,0,0,2,30,31,-1,-1,0,0,-1
Chicago Blackhawks,2013/04/09  vs. MIN,MIN,1,44,37,7,9,-2,0,11,39,28,11,11,0,0,12
Dallas Stars,2013/03/03  vs. STL,STL,1,51,52,-1,-1,3,-3,5,39,36,3,0,7,-4,0
Vancouver Canucks,2013/04/15  vs. NSH,NSH,1,30,54,-24,-2,-22,0,-15,25,44,-19,0,-19,0,-13
Montreal Canadiens,2013/02/18  vs. CAR,CAR,1,37,35,2,-4,6,0,-4,26,28,-2,-6,4,0,-6
Calgary Flames,2013/02/13  vs. DAL,DAL,1,36,45,-9,2,-11,0,2,31,31,0,2,-2,0,2
Anaheim Ducks,2013/03/02  vs. PHX,PHX,1,39,73,-34,-30,-3,-1,-31,28,48,-20,-16,-3,-1,-17
Vancouver Canucks,2013/03/02  vs. LAK,LAK,1,35,36,-1,0,-1,0,4,24,25,-1,-1,0,0,5
Phoenix Coyotes,2013/01/30  vs. EDM,EDM,1,49,42,7,-2,0,9,3,37,32,5,-4,0,9,1
New Jersey Devils,2013/02/03  vs. NYI,NYI,1,36,25,11,10,1,0,10,27,16,11,10,1,0,10
St. Louis Blues,2013/02/11  vs. LAK,LAK,1,25,32,-7,-3,0,-4,-3,20,23,-3,-2,0,-1,0
New York Rangers,2013/04/27  vs. NJD,NJD,1,28,38,-10,3,-13,0,0,24,21,3,3,0,0,4
Anaheim Ducks,2013/03/24  vs. DET,DET,1,48,27,21,-3,0,24,-1,38,19,19,0,0,19,1
San Jose Sharks,2013/02/05  vs. CHI,CHI,1,40,33,7,11,-6,2,7,31,23,8,10,-4,2,6
Calgary Flames,2013/04/13  vs. EDM,EDM,1,49,40,9,5,4,0,10,34,33,1,3,-2,0,7
Toronto Maple Leafs,2013/04/08  vs. NYR,NYR,1,49,62,-13,0,-13,0,-9,33,46,-13,-1,-12,0,-9
Colorado Avalanche,2013/02/04  vs. DAL,DAL,1,31,42,-11,0,0,-11,-4,25,27,-2,4,0,-6,4
Minnesota Wild,2013/04/07  vs. CBJ,CBJ,1,30,36,-6,-4,-2,0,-6,22,22,0,0,0,0,-1
Phoenix Coyotes,2013/02/24  vs. CGY,CGY,1,31,40,-9,5,-8,-6,-4,27,33,-6,6,-6,-6,-2
Tampa Bay Lightning,2013/02/28  vs. NYR,NYR,1,38,53,-15,-12,0,-3,-14,26,34,-8,-9,0,1,-10
Columbus Blue Jackets,2013/03/14  vs. CHI,CHI,1,42,54,-12,-12,0,0,-12,30,37,-7,-7,0,0,-7
Toronto Maple Leafs,2013/03/21  vs. BUF,BUF,1,37,42,-5,3,-3,-5,3,31,33,-2,5,-4,-3,3
Los Angeles Kings,2013/02/19  vs. EDM,EDM,1,62,34,28,21,7,0,27,47,27,20,15,5,0,19
Calgary Flames,2013/04/15  vs. MIN,MIN,1,28,46,-18,-1,0,-17,-5,25,32,-7,0,0,-7,0
Chicago Blackhawks,2013/02/28  vs. STL,STL,1,37,28,9,0,9,0,10,28,21,7,0,7,0,7
Vancouver Canucks,2013/03/18  vs. MIN,MIN,1,57,33,24,20,-1,5,19,40,28,12,10,-1,3,9
San Jose Sharks,2013/02/11  vs. CBJ,CBJ,1,32,42,-10,-1,0,-9,-5,27,34,-7,0,0,-7,1
Carolina Hurricanes,2013/02/02  vs. PHI,PHI,1,63,30,33,4,0,29,8,45,25,20,0,0,20,5
Vancouver Canucks,2013/04/13  vs. COL,COL,1,43,44,-1,0,-7,6,2,30,34,-4,0,-5,1,0
Calgary Flames,2013/03/29  vs. CBJ,CBJ,1,56,43,13,-2,0,15,1,38,32,6,-1,0,7,0
Pittsburgh Penguins,2013/01/27  vs. OTT,OTT,1,36,59,-23,-15,-8,0,-23,26,39,-13,-11,-2,0,-13
Florida Panthers,2013/04/27  vs. TBL,TBL,1,49,46,3,-6,1,8,-1,39,34,5,-2,3,4,2
Washington Capitals,2013/04/04  vs. NYI,NYI,1,42,47,-5,7,-12,0,0,26,33,-7,2,-9,0,-2
Montreal Canadiens,2013/03/23  vs. BUF,BUF,1,70,22,48,32,0,16,34,45,16,29,22,0,7,21
Toronto Maple Leafs,2013/04/20  vs. OTT,OTT,1,32,77,-45,-21,-24,0,-22,25,55,-30,-17,-13,0,-18
Los Angeles Kings,2013/03/02  vs. VAN,VAN,1,36,35,1,0,0,1,-4,25,24,1,1,0,0,-5
Edmonton Oilers,2013/02/16  vs. COL,COL,1,67,43,24,0,0,24,15,53,35,18,0,1,17,9
Buffalo Sabres,2013/04/02  vs. PIT,PIT,1,35,34,1,0,1,0,2,23,19,4,-1,5,0,3
New York Rangers,2013/02/02  vs. TBL,TBL,1,51,46,5,10,-12,7,17,43,36,7,11,-9,5,16
Philadelphia Flyers,2013/04/15  vs. MTL,MTL,1,24,34,-10,-1,-9,0,1,21,27,-6,1,-7,0,3
Florida Panthers,2013/04/25  vs. TOR,TOR,1,56,30,26,3,0,23,4,37,24,13,2,0,11,1
Boston Bruins,2013/01/28  vs. CAR,CAR,1,45,34,11,11,0,0,7,36,27,9,9,0,0,4
New York Islanders,2013/04/18  vs. TOR,TOR,1,52,48,4,5,-9,8,20,43,29,14,5,1,8,17
New York Islanders,2013/04/25  vs. PHI,PHI,1,44,43,1,8,0,-7,3,29,32,-3,2,0,-5,-1
Boston Bruins,2013/03/07  vs. TOR,TOR,1,39,38,1,3,-2,0,0,31,30,1,-1,2,0,-4
Los Angeles Kings,2013/02/27  vs. DET,DET,1,36,40,-4,-5,5,-4,0,31,34,-3,-5,4,-2,1
Winnipeg Jets,2013/04/11  vs. FLA,FLA,1,47,44,3,4,-1,0,3,34,35,-1,-1,0,0,1
New Jersey Devils,2013/02/21  vs. WSH,WSH,1,42,22,20,13,0,7,19,34,13,21,13,3,5,17
Minnesota Wild,2013/01/30  vs. CHI,CHI,1,35,42,-7,-11,1,3,-7,26,36,-10,-10,-1,1,-10
St. Louis Blues,2013/02/09  vs. ANA,ANA,1,51,39,12,18,-8,2,22,34,25,9,12,-4,1,14
Toronto Maple Leafs,2013/04/16  vs. WSH,WSH,1,33,46,-13,-4,0,-9,-9,26,35,-9,-4,0,-5,-9
Tampa Bay Lightning,2013/01/22  vs. CAR,CAR,1,28,51,-23,-2,-21,0,-7,22,37,-15,0,-15,0,-3
Philadelphia Flyers,2013/02/23  vs. WPG,WPG,1,47,41,6,0,-3,9,8,35,32,3,-1,-3,7,5
Toronto Maple Leafs,2013/01/19  vs. MTL,MTL,1,31,35,-4,-1,-3,0,4,26,24,2,-1,3,0,4
Detroit Red Wings,2013/02/28  vs. SJS,SJS,1,59,53,6,6,0,0,6,39,34,5,5,0,0,5
Colorado Avalanche,2013/02/20  vs. STL,STL,1,37,60,-23,-23,0,0,-23,22,42,-20,-20,0,0,-20
Washington Capitals,2013/01/22  vs. WPG,WPG,1,47,47,0,-1,0,1,-2,31,38,-7,-2,0,-5,-6
Columbus Blue Jackets,2013/02/26  vs. DAL,DAL,1,27,52,-25,-13,0,-12,-25,21,40,-19,-11,0,-8,-18
Vancouver Canucks,2013/01/19  vs. ANA,ANA,1,49,35,14,-1,3,12,2,35,29,6,-1,2,5,3
Chicago Blackhawks,2013/02/25  vs. EDM,EDM,1,52,20,32,30,0,2,33,34,16,18,17,0,1,20
New York Rangers,2013/04/16  vs. PHI,PHI,1,52,36,16,2,0,14,4,40,22,18,-2,0,20,1
Anaheim Ducks,2013/03/10  vs. STL,STL,1,27,44,-17,-1,-5,-11,-11,16,37,-21,-2,-5,-14,-15
New York Rangers,2013/03/10  vs. WSH,WSH,1,46,40,6,10,2,-6,5,35,25,10,7,5,-2,6
Phoenix Coyotes,2013/03/04  vs. ANA,ANA,1,49,38,11,4,1,6,12,37,36,1,-1,0,2,3
San Jose Sharks,2013/02/23  vs. DAL,DAL,1,37,37,0,8,0,-8,8,33,30,3,11,0,-8,11
New York Islanders,2013/02/09  vs. BUF,BUF,1,68,34,34,16,0,18,34,50,20,30,18,0,12,28
Florida Panthers,2013/02/24  vs. BOS,BOS,1,51,49,2,4,0,-2,0,37,39,-2,3,0,-5,-1
Nashville Predators,2013/03/15  vs. CGY,CGY,1,40,45,-5,-2,0,-3,0,27,29,-2,0,0,-2,2
Phoenix Coyotes,2013/03/07  vs. STL,STL,1,39,37,2,-1,-2,5,0,24,31,-7,-3,-2,-2,-7
Dallas Stars,2013/04/12  vs. NSH,NSH,1,25,39,-14,4,-18,0,6,20,28,-8,3,-11,0,7
Nashville Predators,2013/02/19  vs. DET,DET,1,29,50,-21,-6,-15,0,-21,24,37,-13,-3,-10,0,-12
Columbus Blue Jackets,2013/01/23  vs. PHX,PHX,1,38,58,-20,-7,1,-14,-12,23,46,-23,-13,1,-11,-17
Florida Panthers,2013/03/28  vs. BUF,BUF,1,42,39,3,1,-2,4,-1,36,34,2,0,-2,4,-2
Winnipeg Jets,2013/04/22  vs. BUF,BUF,1,50,44,6,10,-4,0,10,45,39,6,8,-2,0,9
Florida Panthers,2013/04/07  vs. OTT,OTT,1,29,56,-27,-27,-3,3,-24,22,46,-24,-24,-2,2,-22
Boston Bruins,2013/04/28  vs. OTT,OTT,1,54,40,14,7,0,7,9,43,27,16,7,0,9,12
Columbus Blue Jackets,2013/04/17  vs. ANA,ANA,1,43,37,6,-1,0,7,4,29,31,-2,-8,0,6,-4
Toronto Maple Leafs,2013/03/28  vs. CAR,CAR,1,52,40,12,9,-2,5,5,37,29,8,7,-2,3,2
Detroit Red Wings,2013/03/28  vs. SJS,SJS,1,59,51,8,-3,0,11,1,39,36,3,1,0,2,2
Detroit Red Wings,2013/02/05  vs. CGY,CGY,1,52,33,19,-1,0,20,2,35,25,10,-1,0,11,1
St. Louis Blues,2013/02/28  vs. CHI,CHI,1,28,37,-9,0,0,-9,-10,21,28,-7,0,0,-7,-7
Toronto Maple Leafs,2013/02/14  vs. CAR,CAR,1,33,58,-25,-16,0,-9,-17,24,41,-17,-10,0,-7,-11
Minnesota Wild,2013/03/27  vs. PHX,PHX,1,53,37,16,-3,9,10,4,41,29,12,-2,9,5,4
Detroit Red Wings,2013/02/15  vs. ANA,ANA,1,47,45,2,2,0,0,2,38,34,4,4,1,-1,5
Boston Bruins,2013/04/04  vs. NJD,NJD,1,42,58,-16,-11,-5,0,-7,29,46,-17,-10,-7,0,-8
Dallas Stars,2013/04/21  vs. LAK,LAK,1,32,46,-14,-7,-3,-4,-11,28,36,-8,-4,-1,-3,-6
Florida Panthers,2013/01/26  vs. PHI,PHI,1,48,35,13,-3,0,16,-2,39,27,12,-3,0,15,-2
Edmonton Oilers,2013/03/23  vs. STL,STL,1,28,50,-22,-3,0,-19,-21,20,33,-13,-2,0,-11,-10
Detroit Red Wings,2013/01/21  vs. CBJ,CBJ,1,37,23,14,17,-3,0,16,26,18,8,12,-4,0,9
Phoenix Coyotes,2013/04/20  vs. CHI,CHI,1,39,46,-7,-8,1,0,-7,27,34,-7,-7,0,0,-7
San Jose Sharks,2013/04/16  vs. LAK,LAK,1,51,43,8,5,3,0,5,37,36,1,-1,2,0,-2
Winnipeg Jets,2013/02/01  vs. TBL,TBL,1,41,25,16,5,0,11,6,31,20,11,5,0,6,5
Montreal Canadiens,2013/02/16  vs. PHI,PHI,1,39,30,9,-2,11,0,7,27,21,6,-2,8,0,5
Pittsburgh Penguins,2013/03/02  vs. MTL,MTL,1,50,52,-2,1,-7,4,-3,39,40,-1,0,-4,3,-2
Chicago Blackhawks,2013/02/15  vs. SJS,SJS,1,36,46,-10,-6,-4,0,-5,30,32,-2,-2,0,0,2
Buffalo Sabres,2013/04/13  vs. PHI,PHI,1,34,39,-5,-1,-4,0,-1,26,32,-6,-2,-4,0,-2
Detroit Red Wings,2013/04/07  vs. STL,STL,1,43,31,12,4,0,8,7,33,26,7,4,0,3,5
