Team,Game,Opp Team,GP,SAT For,SAT Agst,SAT,SAT Tied,SAT Ahead,SAT Behind,SAT Close,USAT For,USAT Agst,USAT,USAT Tied,USAT Ahead,USAT Behind,USAT Close
Anaheim Ducks,2014/11/07  vs. ARI,ARI,1,56,41,15,18,-3,0,20,45,29,16,16,0,0,19
Anaheim Ducks,2014/11/23  vs. ARI,ARI,1,55,46,9,24,-15,0,25,43,36,7,16,-9,0,18
Anaheim Ducks,2014/12/27  vs. ARI,ARI,1,58,50,8,9,-1,0,8,47,30,17,17,0,0,17
Anaheim Ducks,2015/03/03  vs. ARI,ARI,1,61,46,15,4,11,0,8,50,36,14,4,10,0,5
Anaheim Ducks,2015/04/11  vs. ARI,ARI,1,48,42,6,1,5,0,5,41,32,9,0,9,0,5
Anaheim Ducks,2014/12/01  vs. BOS,BOS,1,47,55,-8,-5,-3,0,-3,37,36,1,-2,3,0,0
Anaheim Ducks,2015/03/26  vs. BOS,BOS,1,36,31,5,0,0,5,0,31,22,9,4,1,4,5
Anaheim Ducks,2014/10/13  vs. BUF,BUF,1,49,26,23,1,22,0,7,42,12,30,0,30,0,9
Anaheim Ducks,2014/10/22  vs. BUF,BUF,1,54,44,10,0,10,0,3,41,30,11,-1,12,0,2
Anaheim Ducks,2015/02/03  vs. CAR,CAR,1,40,34,6,6,-3,3,3,31,29,2,6,-4,0,2
Anaheim Ducks,2015/02/12  vs. CAR,CAR,1,33,59,-26,-23,-2,-1,-20,24,44,-20,-17,-1,-2,-15
Anaheim Ducks,2014/10/24  vs. CBJ,CBJ,1,41,28,13,1,12,0,6,32,24,8,0,8,0,3
Anaheim Ducks,2015/03/24  vs. CBJ,CBJ,1,50,25,25,1,13,11,14,43,22,21,1,10,10,10
Anaheim Ducks,2014/11/18  vs. CGY,CGY,1,46,28,18,13,5,0,19,25,19,6,5,1,0,8
Anaheim Ducks,2014/11/25  vs. CGY,CGY,1,44,39,5,6,-1,0,-1,37,32,5,6,-1,0,-2
Anaheim Ducks,2015/01/21  vs. CGY,CGY,1,47,51,-4,-1,-3,0,1,33,35,-2,0,-2,0,3
Anaheim Ducks,2015/02/20  vs. CGY,CGY,1,61,41,20,4,2,14,13,43,24,19,3,5,11,11
Anaheim Ducks,2015/03/11  vs. CGY,CGY,1,53,26,27,6,0,21,3,37,22,15,5,-2,12,2
Anaheim Ducks,2014/10/28  vs. CHI,CHI,1,36,52,-16,-11,-5,0,-11,27,39,-12,-7,-5,0,-7
Anaheim Ducks,2014/11/28  vs. CHI,CHI,1,28,45,-17,-5,0,-12,-11,24,39,-15,-4,0,-11,-10
Anaheim Ducks,2015/01/30  vs. CHI,CHI,1,36,54,-18,-6,0,-12,-22,29,41,-12,-4,0,-8,-14
Anaheim Ducks,2014/11/02  vs. COL,COL,1,35,28,7,4,2,1,10,26,21,5,1,3,1,5
Anaheim Ducks,2015/03/20  vs. COL,COL,1,58,32,26,8,17,1,19,45,25,20,8,11,1,13
Anaheim Ducks,2015/04/03  vs. COL,COL,1,51,33,18,11,4,3,14,41,27,14,7,5,2,11
Anaheim Ducks,2014/10/31  vs. DAL,DAL,1,27,37,-10,-6,-4,0,-9,19,26,-7,-7,0,0,-9
Anaheim Ducks,2015/03/01  vs. DAL,DAL,1,39,68,-29,-7,-22,0,-26,30,45,-15,-1,-14,0,-11
Anaheim Ducks,2015/04/08  vs. DAL,DAL,1,36,56,-20,-12,0,-8,-16,28,46,-18,-7,0,-11,-11
Anaheim Ducks,2014/10/11  vs. DET,DET,1,35,42,-7,-4,0,-3,-5,25,27,-2,1,-1,-2,-1
Anaheim Ducks,2015/02/23  vs. DET,DET,1,38,39,-1,-4,-1,4,-5,28,33,-5,-6,-1,2,-7
Anaheim Ducks,2014/12/10  vs. EDM,EDM,1,37,37,0,4,-4,0,0,31,28,3,4,-1,0,2
Anaheim Ducks,2014/12/12  vs. EDM,EDM,1,29,38,-9,2,-11,0,6,23,26,-3,2,-5,0,5
Anaheim Ducks,2015/02/21  vs. EDM,EDM,1,39,48,-9,0,-9,0,-8,26,31,-5,0,-5,0,-4
Anaheim Ducks,2015/04/01  vs. EDM,EDM,1,44,44,0,-7,7,0,-5,38,32,6,-4,10,0,-2
Anaheim Ducks,2014/11/16  vs. FLA,FLA,1,67,49,18,3,0,15,7,48,42,6,3,0,3,7
Anaheim Ducks,2015/02/10  vs. FLA,FLA,1,50,27,23,4,0,19,4,36,23,13,3,0,10,3
Anaheim Ducks,2014/11/12  vs. LAK,LAK,1,70,41,29,9,0,20,33,54,34,20,9,0,11,27
Anaheim Ducks,2014/11/15  vs. LAK,LAK,1,47,49,-2,5,-7,0,1,37,38,-1,5,-6,0,1
Anaheim Ducks,2015/01/17  vs. LAK,LAK,1,48,46,2,-4,0,6,0,38,36,2,-2,0,4,1
Anaheim Ducks,2015/02/27  vs. LAK,LAK,1,46,53,-7,-5,1,-3,2,39,37,2,-1,1,2,10
Anaheim Ducks,2015/03/18  vs. LAK,LAK,1,35,47,-12,-4,-10,2,-4,28,33,-5,1,-6,0,-1
Anaheim Ducks,2014/10/17  vs. MIN,MIN,1,39,37,2,-2,-3,7,3,30,26,4,2,-2,4,5
Anaheim Ducks,2014/12/05  vs. MIN,MIN,1,39,40,-1,1,0,-2,8,28,27,1,1,2,-2,8
Anaheim Ducks,2015/03/13  vs. MIN,MIN,1,28,36,-8,-6,-2,0,-4,19,30,-11,-7,-4,0,-8
Anaheim Ducks,2014/12/18  vs. MTL,MTL,1,49,42,7,15,-8,0,3,31,29,2,7,-5,0,-1
Anaheim Ducks,2015/03/04  vs. MTL,MTL,1,51,50,1,4,-3,0,-4,41,37,4,3,1,0,-2
Anaheim Ducks,2015/01/16  vs. NJD,NJD,1,59,36,23,8,15,0,15,41,21,20,2,18,0,11
Anaheim Ducks,2015/03/29  vs. NJD,NJD,1,35,36,-1,0,-1,0,-3,27,30,-3,-3,0,0,-4
Anaheim Ducks,2015/01/04  vs. NSH,NSH,1,54,33,21,5,7,9,12,41,25,16,7,7,2,14
Anaheim Ducks,2015/02/05  vs. NSH,NSH,1,25,53,-28,-1,-27,0,-3,20,44,-24,-1,-23,0,-2
Anaheim Ducks,2015/03/15  vs. NSH,NSH,1,34,42,-8,-11,-3,6,-15,25,28,-3,-6,-2,5,-10
Anaheim Ducks,2014/11/05  vs. NYI,NYI,1,56,56,0,-1,0,1,8,41,40,1,4,0,-3,7
Anaheim Ducks,2015/03/28  vs. NYI,NYI,1,48,59,-11,-2,-9,0,-2,34,40,-6,-1,-5,0,0
Anaheim Ducks,2015/01/07  vs. NYR,NYR,1,65,57,8,0,0,8,4,46,43,3,-1,0,4,1
Anaheim Ducks,2015/03/22  vs. NYR,NYR,1,65,45,20,7,0,13,7,53,34,19,6,0,13,10
Anaheim Ducks,2014/12/19  vs. OTT,OTT,1,53,45,8,2,0,6,3,37,35,2,1,0,1,3
Anaheim Ducks,2015/02/25  vs. OTT,OTT,1,41,42,-1,1,0,-2,-4,29,32,-3,2,0,-5,-3
Anaheim Ducks,2014/10/14  vs. PHI,PHI,1,34,57,-23,-7,-16,0,-4,27,36,-9,-4,-5,0,1
Anaheim Ducks,2014/12/03  vs. PHI,PHI,1,48,32,16,11,3,2,12,36,27,9,9,1,-1,7
Anaheim Ducks,2014/10/09  vs. PIT,PIT,1,34,47,-13,-2,0,-11,-3,26,38,-12,-1,0,-11,-2
Anaheim Ducks,2015/03/06  vs. PIT,PIT,1,39,30,9,-2,0,11,-4,29,23,6,-2,0,8,-3
Anaheim Ducks,2014/10/26  vs. SJS,SJS,1,41,43,-2,-8,0,6,-12,28,32,-4,-2,0,-2,-6
Anaheim Ducks,2014/11/29  vs. SJS,SJS,1,33,41,-8,-9,0,1,-16,25,34,-9,-7,0,-2,-13
Anaheim Ducks,2014/12/22  vs. SJS,SJS,1,45,54,-9,-15,-3,9,-19,36,41,-5,-11,-2,8,-13
Anaheim Ducks,2014/12/31  vs. SJS,SJS,1,45,30,15,-4,0,19,-2,35,22,13,-2,0,15,1
Anaheim Ducks,2015/01/29  vs. SJS,SJS,1,52,45,7,11,2,-6,16,32,27,5,9,1,-5,12
Anaheim Ducks,2014/10/19  vs. STL,STL,1,39,46,-7,1,-8,0,4,30,34,-4,1,-5,0,4
Anaheim Ducks,2014/10/30  vs. STL,STL,1,36,46,-10,2,0,-12,0,27,37,-10,0,0,-10,-1
Anaheim Ducks,2015/01/02  vs. STL,STL,1,41,41,0,2,-2,0,4,30,34,-4,-2,-2,0,0
Anaheim Ducks,2015/02/08  vs. TBL,TBL,1,41,28,13,0,0,13,0,29,22,7,0,0,7,0
Anaheim Ducks,2015/02/18  vs. TBL,TBL,1,53,47,6,5,-9,10,-3,38,37,1,0,-7,8,-7
Anaheim Ducks,2014/12/16  vs. TOR,TOR,1,76,49,27,2,0,25,7,60,37,23,-1,0,24,4
Anaheim Ducks,2015/01/14  vs. TOR,TOR,1,38,38,0,0,0,0,1,30,29,1,-2,3,0,-3
Anaheim Ducks,2014/11/09  vs. VAN,VAN,1,51,52,-1,1,-2,0,-1,34,42,-8,-3,-5,0,-8
Anaheim Ducks,2014/11/20  vs. VAN,VAN,1,37,52,-15,-1,-16,2,-9,25,32,-7,-1,-5,-1,-3
Anaheim Ducks,2014/12/28  vs. VAN,VAN,1,61,45,16,3,0,13,13,47,34,13,3,0,10,13
Anaheim Ducks,2015/01/27  vs. VAN,VAN,1,37,32,5,5,0,0,0,28,22,6,4,2,0,0
Anaheim Ducks,2015/03/09  vs. VAN,VAN,1,56,30,26,3,0,23,21,41,22,19,3,0,16,13
Anaheim Ducks,2014/12/07  vs. WPG,WPG,1,24,44,-20,-7,-15,2,-19,18,32,-14,-6,-10,2,-13
Anaheim Ducks,2014/12/13  vs. WPG,WPG,1,31,47,-16,-5,-10,-1,-9,22,31,-9,-2,-5,-2,-5
Anaheim Ducks,2015/01/11  vs. WPG,WPG,1,41,36,5,1,0,4,2,33,27,6,0,0,6,1
Anaheim Ducks,2015/02/06  vs. WSH,WSH,1,42,56,-14,-12,0,-2,-12,26,42,-16,-14,1,-3,-13
Anaheim Ducks,2015/02/15  vs. WSH,WSH,1,47,45,2,7,0,-5,3,36,35,1,6,0,-5,6
Arizona Coyotes,2014/11/07  vs. ANA,ANA,1,41,56,-15,-18,0,3,-20,29,45,-16,-16,0,0,-19
Arizona Coyotes,2014/11/23  vs. ANA,ANA,1,46,55,-9,-24,0,15,-25,36,43,-7,-16,0,9,-18
Arizona Coyotes,2014/12/27  vs. ANA,ANA,1,50,58,-8,-9,0,1,-8,30,47,-17,-17,0,0,-17
Arizona Coyotes,2015/03/03  vs. ANA,ANA,1,46,61,-15,-4,0,-11,-8,36,50,-14,-4,0,-10,-5
Arizona Coyotes,2015/04/11  vs. ANA,ANA,1,42,48,-6,-1,0,-5,-5,32,41,-9,0,0,-9,-5
Arizona Coyotes,2014/12/06  vs. BOS,BOS,1,43,38,5,2,0,3,8,35,28,7,2,0,5,8
Arizona Coyotes,2015/02/28  vs. BOS,BOS,1,48,36,12,2,0,10,0,38,27,11,2,0,9,1
Arizona Coyotes,2015/03/26  vs. BUF,BUF,1,53,39,14,10,4,0,14,38,31,7,3,4,0,7
Arizona Coyotes,2015/03/30  vs. BUF,BUF,1,44,58,-14,-2,-10,-2,-20,30,41,-11,-2,-4,-5,-14
Arizona Coyotes,2014/11/01  vs. CAR,CAR,1,35,44,-9,-5,0,-4,-5,24,34,-10,-3,0,-7,-3
Arizona Coyotes,2015/02/05  vs. CAR,CAR,1,49,49,0,-5,0,5,0,36,37,-1,-5,0,4,-1
Arizona Coyotes,2015/01/03  vs. CBJ,CBJ,1,48,36,12,12,-1,1,14,37,24,13,9,3,1,11
Arizona Coyotes,2015/02/03  vs. CBJ,CBJ,1,43,50,-7,13,-20,0,8,28,37,-9,7,-16,0,2
Arizona Coyotes,2014/11/13  vs. CGY,CGY,1,44,37,7,6,0,1,-1,29,27,2,6,0,-4,-4
Arizona Coyotes,2014/11/29  vs. CGY,CGY,1,57,44,13,-8,0,21,-1,33,28,5,-7,0,12,-1
Arizona Coyotes,2014/12/02  vs. CGY,CGY,1,60,35,25,14,0,11,16,37,29,8,6,0,2,5
Arizona Coyotes,2015/01/15  vs. CGY,CGY,1,52,46,6,6,0,0,7,40,35,5,10,0,-5,11
Arizona Coyotes,2015/04/07  vs. CGY,CGY,1,55,48,7,8,0,-1,4,30,32,-2,3,0,-5,-2
Arizona Coyotes,2015/01/20  vs. CHI,CHI,1,42,62,-20,3,0,-23,-7,33,48,-15,3,0,-18,-7
Arizona Coyotes,2015/02/09  vs. CHI,CHI,1,50,54,-4,-2,-1,-1,-3,33,39,-6,-2,-1,-3,-5
Arizona Coyotes,2015/03/12  vs. CHI,CHI,1,31,50,-19,-16,-3,0,-19,25,34,-9,-10,-2,3,-12
Arizona Coyotes,2014/11/25  vs. COL,COL,1,49,50,-1,-2,1,0,0,42,36,6,0,6,0,3
Arizona Coyotes,2015/02/16  vs. COL,COL,1,41,41,0,2,0,-2,-2,25,38,-13,1,0,-14,-5
Arizona Coyotes,2015/03/19  vs. COL,COL,1,55,40,15,5,5,5,13,46,31,15,4,3,8,9
Arizona Coyotes,2014/11/11  vs. DAL,DAL,1,50,40,10,6,5,-1,15,35,28,7,2,6,-1,11
Arizona Coyotes,2014/11/20  vs. DAL,DAL,1,37,50,-13,0,-8,-5,-8,26,44,-18,-2,-9,-7,-11
Arizona Coyotes,2014/12/31  vs. DAL,DAL,1,45,54,-9,-8,0,-1,-9,31,45,-14,-6,0,-8,-7
Arizona Coyotes,2015/02/07  vs. DET,DET,1,27,34,-7,-8,0,1,-6,16,20,-4,-4,0,0,-3
Arizona Coyotes,2015/03/24  vs. DET,DET,1,28,47,-19,-20,1,0,-18,21,37,-16,-15,-1,0,-15
Arizona Coyotes,2014/10/15  vs. EDM,EDM,1,35,40,-5,0,-5,0,0,29,26,3,2,1,0,3
Arizona Coyotes,2014/11/16  vs. EDM,EDM,1,45,44,1,-7,8,0,-6,29,30,-1,-6,5,0,-6
Arizona Coyotes,2014/12/01  vs. EDM,EDM,1,32,36,-4,3,-7,0,1,22,28,-6,-1,-5,0,-3
Arizona Coyotes,2014/12/16  vs. EDM,EDM,1,61,51,10,2,0,8,10,44,38,6,0,0,6,6
Arizona Coyotes,2014/12/23  vs. EDM,EDM,1,47,38,9,3,6,0,3,29,26,3,3,0,0,-2
Arizona Coyotes,2014/10/25  vs. FLA,FLA,1,46,34,12,11,0,1,11,34,29,5,5,0,0,5
Arizona Coyotes,2014/10/30  vs. FLA,FLA,1,31,40,-9,-5,-3,-1,-8,24,26,-2,2,-1,-3,1
Arizona Coyotes,2014/10/11  vs. LAK,LAK,1,46,46,0,-6,0,6,2,41,28,13,3,0,10,14
Arizona Coyotes,2014/12/04  vs. LAK,LAK,1,43,64,-21,4,0,-25,-2,34,48,-14,2,0,-16,4
Arizona Coyotes,2014/12/20  vs. LAK,LAK,1,40,49,-9,-10,-2,3,-12,30,40,-10,-10,-1,1,-12
Arizona Coyotes,2015/03/16  vs. LAK,LAK,1,30,52,-22,-10,0,-12,-13,24,37,-13,-3,0,-10,-5
Arizona Coyotes,2014/10/23  vs. MIN,MIN,1,43,50,-7,-10,0,3,-9,31,34,-3,-8,0,5,-7
Arizona Coyotes,2014/12/13  vs. MIN,MIN,1,60,51,9,-1,9,1,8,40,35,5,-7,11,1,1
Arizona Coyotes,2015/01/17  vs. MIN,MIN,1,44,39,5,5,0,0,-9,29,31,-2,-1,0,-1,-11
Arizona Coyotes,2015/02/01  vs. MTL,MTL,1,44,41,3,3,-9,9,5,32,27,5,2,-3,6,3
Arizona Coyotes,2015/03/07  vs. MTL,MTL,1,59,57,2,-13,0,15,-15,42,44,-2,-12,0,10,-13
Arizona Coyotes,2015/02/23  vs. NJD,NJD,1,45,35,10,3,0,7,11,36,30,6,1,0,5,4
Arizona Coyotes,2015/03/14  vs. NJD,NJD,1,56,42,14,6,0,8,4,39,31,8,3,0,5,1
Arizona Coyotes,2014/10/21  vs. NSH,NSH,1,39,36,3,5,2,-4,3,28,26,2,3,0,-1,2
Arizona Coyotes,2014/12/11  vs. NSH,NSH,1,52,46,6,3,0,3,6,38,34,4,2,1,1,5
Arizona Coyotes,2015/03/09  vs. NSH,NSH,1,52,49,3,-12,0,15,-6,37,38,-1,-7,0,6,-5
Arizona Coyotes,2014/11/08  vs. NYI,NYI,1,26,51,-25,-22,0,-3,-22,14,38,-24,-21,0,-3,-21
Arizona Coyotes,2015/02/24  vs. NYI,NYI,1,61,59,2,-1,0,3,8,39,38,1,2,0,-1,5
Arizona Coyotes,2015/02/14  vs. NYR,NYR,1,56,59,-3,-4,0,1,-2,48,44,4,1,0,3,3
Arizona Coyotes,2015/02/26  vs. NYR,NYR,1,51,54,-3,0,0,-3,4,47,41,6,4,4,-2,11
Arizona Coyotes,2015/01/10  vs. OTT,OTT,1,33,37,-4,0,3,-7,-7,27,27,0,1,3,-4,-1
Arizona Coyotes,2015/01/31  vs. OTT,OTT,1,40,41,-1,-6,0,5,-7,29,31,-2,-3,0,1,-4
Arizona Coyotes,2014/12/29  vs. PHI,PHI,1,36,55,-19,-16,-3,0,-20,28,42,-14,-14,0,0,-16
Arizona Coyotes,2015/01/27  vs. PHI,PHI,1,40,64,-24,-9,-14,-1,-26,33,49,-16,-6,-9,-1,-18
Arizona Coyotes,2015/03/21  vs. PIT,PIT,1,42,44,-2,-3,10,-9,2,31,37,-6,-3,7,-10,-1
Arizona Coyotes,2015/03/28  vs. PIT,PIT,1,28,40,-12,-10,-4,2,-10,18,36,-18,-15,-4,1,-15
Arizona Coyotes,2014/11/22  vs. SJS,SJS,1,35,67,-32,-14,-18,0,-26,19,43,-24,-9,-15,0,-19
Arizona Coyotes,2015/01/13  vs. SJS,SJS,1,41,48,-7,-6,3,-4,-4,32,31,1,0,2,-1,3
Arizona Coyotes,2015/02/13  vs. SJS,SJS,1,58,33,25,10,9,6,19,44,25,19,9,8,2,17
Arizona Coyotes,2015/04/03  vs. SJS,SJS,1,38,62,-24,1,0,-25,-13,24,46,-22,0,0,-22,-10
Arizona Coyotes,2015/04/04  vs. SJS,SJS,1,45,57,-12,-1,-11,0,-3,33,43,-10,-4,-6,0,-3
Arizona Coyotes,2014/10/18  vs. STL,STL,1,37,56,-19,-11,0,-8,-12,25,44,-19,-8,0,-11,-12
Arizona Coyotes,2015/01/06  vs. STL,STL,1,43,48,-5,-8,0,3,-13,31,43,-12,-7,0,-5,-14
Arizona Coyotes,2015/02/10  vs. STL,STL,1,39,47,-8,-1,-6,-1,-10,28,37,-9,-3,-4,-2,-12
Arizona Coyotes,2014/10/28  vs. TBL,TBL,1,52,55,-3,-1,0,-2,-6,36,44,-8,-2,0,-6,-6
Arizona Coyotes,2015/02/21  vs. TBL,TBL,1,47,46,1,0,-5,6,-8,38,31,7,4,-3,6,-2
Arizona Coyotes,2014/11/04  vs. TOR,TOR,1,40,34,6,1,5,0,9,33,25,8,1,7,0,6
Arizona Coyotes,2015/01/29  vs. TOR,TOR,1,44,40,4,3,-3,4,7,39,30,9,1,0,8,9
Arizona Coyotes,2014/11/14  vs. VAN,VAN,1,33,51,-18,-9,-9,0,-16,26,33,-7,-6,-1,0,-12
Arizona Coyotes,2014/12/22  vs. VAN,VAN,1,62,28,34,4,0,30,6,45,21,24,3,0,21,4
Arizona Coyotes,2015/03/05  vs. VAN,VAN,1,45,48,-3,8,-11,0,-7,33,36,-3,8,-11,0,-7
Arizona Coyotes,2015/03/22  vs. VAN,VAN,1,61,69,-8,-14,0,6,-13,42,51,-9,-13,0,4,-12
Arizona Coyotes,2015/04/09  vs. VAN,VAN,1,37,42,-5,-7,0,2,-15,29,31,-2,-2,0,0,-7
Arizona Coyotes,2014/10/09  vs. WPG,WPG,1,41,22,19,3,0,16,1,30,17,13,2,0,11,0
Arizona Coyotes,2015/01/08  vs. WPG,WPG,1,31,51,-20,-1,-19,0,-1,27,39,-12,-1,-11,0,-1
Arizona Coyotes,2015/01/18  vs. WPG,WPG,1,39,42,-3,7,0,-10,-9,30,35,-5,3,0,-8,-11
Arizona Coyotes,2014/11/02  vs. WSH,WSH,1,45,42,3,-4,0,7,0,31,30,1,-3,-2,6,1
Arizona Coyotes,2014/11/18  vs. WSH,WSH,1,32,30,2,3,0,-1,2,21,20,1,3,0,-2,1
Boston Bruins,2014/12/01  vs. ANA,ANA,1,55,47,8,5,0,3,3,36,37,-1,2,0,-3,0
Boston Bruins,2015/03/26  vs. ANA,ANA,1,31,36,-5,0,-5,0,0,22,31,-9,-4,-4,-1,-5
Boston Bruins,2014/12/06  vs. ARI,ARI,1,38,43,-5,-2,-3,0,-8,28,35,-7,-2,-5,0,-8
Boston Bruins,2015/02/28  vs. ARI,ARI,1,36,48,-12,-2,-10,0,0,27,38,-11,-2,-9,0,-1
Boston Bruins,2014/10/18  vs. BUF,BUF,1,51,36,15,-5,20,0,1,35,25,10,-3,13,0,-1
Boston Bruins,2014/10/30  vs. BUF,BUF,1,59,25,34,14,0,20,24,45,15,30,13,0,17,19
Boston Bruins,2014/12/21  vs. BUF,BUF,1,57,28,29,4,5,20,10,39,25,14,0,4,10,5
Boston Bruins,2015/03/17  vs. BUF,BUF,1,76,34,42,20,22,0,42,53,27,26,13,13,0,26
Boston Bruins,2014/11/15  vs. CAR,CAR,1,39,45,-6,-1,-2,-3,4,30,36,-6,-1,-1,-4,5
Boston Bruins,2015/01/04  vs. CAR,CAR,1,44,56,-12,-14,0,2,-12,31,47,-16,-17,0,1,-16
Boston Bruins,2015/03/29  vs. CAR,CAR,1,37,57,-20,-6,-14,0,-20,33,49,-16,-7,-9,0,-16
Boston Bruins,2014/11/21  vs. CBJ,CBJ,1,60,48,12,6,0,6,5,43,39,4,1,1,2,-1
Boston Bruins,2014/12/27  vs. CBJ,CBJ,1,46,34,12,1,0,11,-3,33,30,3,-1,0,4,-3
Boston Bruins,2015/01/17  vs. CBJ,CBJ,1,56,42,14,10,0,4,14,42,30,12,10,0,2,12
Boston Bruins,2015/02/16  vs. CGY,CGY,1,43,39,4,4,0,0,6,30,27,3,1,2,0,3
Boston Bruins,2015/03/05  vs. CGY,CGY,1,67,34,33,18,11,4,29,38,29,9,8,-2,3,6
Boston Bruins,2014/12/11  vs. CHI,CHI,1,51,35,16,3,0,13,1,41,30,11,3,0,8,1
Boston Bruins,2015/02/22  vs. CHI,CHI,1,38,43,-5,3,-8,0,-2,30,27,3,1,2,0,-1
Boston Bruins,2014/10/13  vs. COL,COL,1,44,36,8,11,0,-3,9,34,28,6,8,0,-2,7
Boston Bruins,2015/01/21  vs. COL,COL,1,45,44,1,-4,-4,9,5,33,23,10,6,-2,6,12
Boston Bruins,2015/01/20  vs. DAL,DAL,1,39,51,-12,2,-13,-1,2,31,39,-8,1,-7,-2,-1
Boston Bruins,2015/02/10  vs. DAL,DAL,1,49,41,8,12,0,-4,4,37,35,2,9,0,-7,1
Boston Bruins,2014/10/09  vs. DET,DET,1,16,40,-24,-21,0,-3,-23,12,28,-16,-16,0,0,-17
Boston Bruins,2014/10/15  vs. DET,DET,1,48,28,20,16,4,0,21,37,20,17,14,3,0,18
Boston Bruins,2014/12/29  vs. DET,DET,1,51,37,14,3,11,0,2,44,27,17,2,15,0,6
Boston Bruins,2015/03/08  vs. DET,DET,1,30,45,-15,2,-17,0,-5,25,35,-10,1,-11,0,-1
Boston Bruins,2015/04/02  vs. DET,DET,1,21,45,-24,-17,1,-8,-26,16,39,-23,-17,1,-7,-25
Boston Bruins,2014/11/06  vs. EDM,EDM,1,37,42,-5,-6,4,-3,-9,27,33,-6,-7,4,-3,-9
Boston Bruins,2015/02/18  vs. EDM,EDM,1,56,41,15,7,0,8,12,43,26,17,10,0,7,14
Boston Bruins,2014/11/04  vs. FLA,FLA,1,49,39,10,10,0,0,10,37,28,9,9,0,0,9
Boston Bruins,2015/03/21  vs. FLA,FLA,1,39,37,2,6,0,-4,2,32,30,2,6,0,-4,2
Boston Bruins,2015/03/31  vs. FLA,FLA,1,45,35,10,4,4,2,7,30,24,6,2,1,3,3
Boston Bruins,2015/04/09  vs. FLA,FLA,1,43,48,-5,-5,-3,3,-8,37,35,2,2,-3,3,-1
Boston Bruins,2014/12/02  vs. LAK,LAK,1,55,46,9,-1,0,10,-2,46,35,11,3,0,8,1
Boston Bruins,2015/01/31  vs. LAK,LAK,1,43,52,-9,2,-11,0,2,34,38,-4,1,-5,0,2
Boston Bruins,2014/10/28  vs. MIN,MIN,1,44,64,-20,-2,-24,6,-15,31,48,-17,0,-18,1,-11
Boston Bruins,2014/12/17  vs. MIN,MIN,1,31,56,-25,-5,-20,0,-17,21,46,-25,-4,-21,0,-18
Boston Bruins,2014/10/16  vs. MTL,MTL,1,44,39,5,2,0,3,4,27,25,2,2,-1,1,0
Boston Bruins,2014/11/13  vs. MTL,MTL,1,40,39,1,5,-5,1,0,22,29,-7,3,-4,-6,-2
Boston Bruins,2014/11/22  vs. MTL,MTL,1,52,36,16,6,0,10,14,43,27,16,4,0,12,16
Boston Bruins,2015/02/08  vs. MTL,MTL,1,69,48,21,3,0,18,11,48,37,11,1,0,10,1
Boston Bruins,2014/11/10  vs. NJD,NJD,1,41,50,-9,0,-9,0,3,31,35,-4,1,-4,-1,5
Boston Bruins,2015/01/08  vs. NJD,NJD,1,59,32,27,11,16,0,22,42,25,17,7,10,0,12
Boston Bruins,2015/02/27  vs. NJD,NJD,1,48,38,10,-6,16,0,6,35,31,4,-6,10,0,-1
Boston Bruins,2014/12/16  vs. NSH,NSH,1,36,47,-11,-3,-4,-4,-7,26,35,-9,-5,-1,-3,-6
Boston Bruins,2014/12/23  vs. NSH,NSH,1,34,37,-3,1,-4,0,9,24,30,-6,0,-6,0,5
Boston Bruins,2014/10/23  vs. NYI,NYI,1,60,52,8,-2,0,10,-6,41,48,-7,-4,0,-3,-12
Boston Bruins,2015/01/29  vs. NYI,NYI,1,53,64,-11,4,-15,0,8,39,51,-12,0,-12,0,3
Boston Bruins,2015/02/07  vs. NYI,NYI,1,48,53,-5,-6,-2,3,-3,40,40,0,-2,0,2,0
Boston Bruins,2015/01/15  vs. NYR,NYR,1,45,34,11,5,6,0,13,33,26,7,3,4,0,8
Boston Bruins,2015/02/04  vs. NYR,NYR,1,37,49,-12,-5,2,-9,-11,26,30,-4,-3,4,-5,-5
Boston Bruins,2015/03/28  vs. NYR,NYR,1,47,56,-9,3,-12,0,8,39,41,-2,2,-4,0,7
Boston Bruins,2014/11/01  vs. OTT,OTT,1,56,39,17,14,3,0,15,42,31,11,6,5,0,8
Boston Bruins,2014/12/13  vs. OTT,OTT,1,51,47,4,-1,5,0,-1,39,31,8,6,2,0,3
Boston Bruins,2015/01/03  vs. OTT,OTT,1,43,32,11,12,-1,0,12,33,28,5,6,0,-1,5
Boston Bruins,2015/03/10  vs. OTT,OTT,1,31,58,-27,2,-29,0,-8,24,39,-15,2,-17,0,-4
Boston Bruins,2015/03/19  vs. OTT,OTT,1,39,52,-13,5,-5,-13,-8,29,39,-10,2,-3,-9,-7
Boston Bruins,2014/10/08  vs. PHI,PHI,1,50,34,16,6,10,0,12,37,21,16,8,8,0,11
Boston Bruins,2015/01/10  vs. PHI,PHI,1,30,42,-12,1,-13,0,-3,21,30,-9,3,-12,0,-4
Boston Bruins,2015/03/07  vs. PHI,PHI,1,47,45,2,-6,7,1,1,29,38,-9,-10,1,0,-9
Boston Bruins,2014/11/24  vs. PIT,PIT,1,43,48,-5,-2,-3,0,-5,36,36,0,1,-2,1,0
Boston Bruins,2015/01/07  vs. PIT,PIT,1,37,53,-16,-10,2,-8,-16,28,42,-14,-12,3,-5,-14
Boston Bruins,2015/03/14  vs. PIT,PIT,1,41,45,-4,-3,-1,0,2,29,36,-7,-4,-3,0,-3
Boston Bruins,2014/10/21  vs. SJS,SJS,1,55,44,11,10,4,-3,14,39,32,7,5,4,-2,8
Boston Bruins,2014/12/04  vs. SJS,SJS,1,40,57,-17,-11,-3,-3,-14,30,42,-12,-9,0,-3,-12
Boston Bruins,2014/11/18  vs. STL,STL,1,35,47,-12,2,-14,0,-1,23,37,-14,0,-14,0,-5
Boston Bruins,2015/02/20  vs. STL,STL,1,39,28,11,7,-2,6,5,25,22,3,5,-2,0,3
Boston Bruins,2015/01/13  vs. TBL,TBL,1,46,25,21,11,12,-2,11,38,20,18,7,14,-3,6
Boston Bruins,2015/03/12  vs. TBL,TBL,1,38,47,-9,-5,-4,0,-2,31,38,-7,-7,0,0,-2
Boston Bruins,2015/03/22  vs. TBL,TBL,1,48,37,11,-1,-3,15,-5,29,22,7,-1,-3,11,-5
Boston Bruins,2015/04/11  vs. TBL,TBL,1,51,40,11,10,0,1,9,34,29,5,6,0,-1,6
Boston Bruins,2014/10/25  vs. TOR,TOR,1,45,37,8,0,8,0,8,32,25,7,0,7,0,8
Boston Bruins,2014/11/12  vs. TOR,TOR,1,58,46,12,-3,0,15,5,33,40,-7,-5,0,-2,-4
Boston Bruins,2014/12/31  vs. TOR,TOR,1,48,39,9,16,0,-7,11,31,29,2,10,0,-8,4
Boston Bruins,2015/04/04  vs. TOR,TOR,1,58,31,27,25,2,0,27,44,25,19,17,2,0,19
Boston Bruins,2015/02/13  vs. VAN,VAN,1,47,42,5,-1,0,6,-2,32,32,0,-1,0,1,-2
Boston Bruins,2015/02/24  vs. VAN,VAN,1,53,36,17,9,0,8,9,40,31,9,5,0,4,5
Boston Bruins,2014/11/28  vs. WPG,WPG,1,39,43,-4,-5,0,1,-3,30,33,-3,-2,0,-1,-1
Boston Bruins,2014/12/19  vs. WPG,WPG,1,39,34,5,5,0,0,-3,32,24,8,5,0,3,-3
Boston Bruins,2014/10/11  vs. WSH,WSH,1,42,25,17,1,0,16,8,33,18,15,2,0,13,9
Boston Bruins,2015/03/15  vs. WSH,WSH,1,47,57,-10,-7,0,-3,-4,31,47,-16,-8,0,-8,-10
Boston Bruins,2015/04/08  vs. WSH,WSH,1,64,50,14,3,0,11,-2,46,40,6,2,0,4,-3
Buffalo Sabres,2014/10/13  vs. ANA,ANA,1,26,49,-23,-1,0,-22,-7,12,42,-30,0,0,-30,-9
Buffalo Sabres,2014/10/22  vs. ANA,ANA,1,44,54,-10,0,0,-10,-3,30,41,-11,1,0,-12,-2
Buffalo Sabres,2015/03/26  vs. ARI,ARI,1,39,53,-14,-10,0,-4,-14,31,38,-7,-3,0,-4,-7
Buffalo Sabres,2015/03/30  vs. ARI,ARI,1,58,44,14,2,2,10,20,41,30,11,2,5,4,14
Buffalo Sabres,2014/10/18  vs. BOS,BOS,1,36,51,-15,5,0,-20,-1,25,35,-10,3,0,-13,1
Buffalo Sabres,2014/10/30  vs. BOS,BOS,1,25,59,-34,-14,-20,0,-24,15,45,-30,-13,-17,0,-19
Buffalo Sabres,2014/12/21  vs. BOS,BOS,1,28,57,-29,-4,-20,-5,-10,25,39,-14,0,-10,-4,-5
Buffalo Sabres,2015/03/17  vs. BOS,BOS,1,34,76,-42,-20,0,-22,-42,27,53,-26,-13,0,-13,-26
Buffalo Sabres,2014/10/14  vs. CAR,CAR,1,24,55,-31,-7,-24,0,-15,18,42,-24,-10,-14,0,-10
Buffalo Sabres,2015/01/08  vs. CAR,CAR,1,31,57,-26,-17,0,-9,-17,26,35,-9,-7,0,-2,-8
Buffalo Sabres,2015/04/06  vs. CAR,CAR,1,31,79,-48,0,-48,0,-14,30,62,-32,0,-32,0,-9
Buffalo Sabres,2014/10/09  vs. CBJ,CBJ,1,33,54,-21,-22,0,1,-24,28,40,-12,-11,0,-1,-13
Buffalo Sabres,2015/02/24  vs. CBJ,CBJ,1,30,56,-26,-5,-21,0,-7,26,43,-17,-4,-13,0,-6
Buffalo Sabres,2015/04/10  vs. CBJ,CBJ,1,32,57,-25,-3,0,-22,-21,28,46,-18,-1,0,-17,-14
Buffalo Sabres,2014/12/11  vs. CGY,CGY,1,33,54,-21,-16,1,-6,-13,24,37,-13,-12,4,-5,-9
Buffalo Sabres,2015/01/27  vs. CGY,CGY,1,35,54,-19,-14,1,-6,-13,19,36,-17,-13,0,-4,-13
Buffalo Sabres,2014/10/11  vs. CHI,CHI,1,25,60,-35,-15,0,-20,-24,20,48,-28,-10,0,-18,-17
Buffalo Sabres,2015/04/03  vs. CHI,CHI,1,34,45,-11,-4,-4,-3,-6,27,31,-4,-4,-3,3,-4
Buffalo Sabres,2014/12/20  vs. COL,COL,1,38,36,2,0,0,2,-1,28,24,4,1,0,3,1
Buffalo Sabres,2015/03/28  vs. COL,COL,1,45,38,7,-6,0,13,-7,30,31,-1,-6,0,5,-7
Buffalo Sabres,2015/02/07  vs. DAL,DAL,1,31,71,-40,-6,-34,0,-6,24,49,-25,-7,-18,0,-7
Buffalo Sabres,2015/03/23  vs. DAL,DAL,1,39,84,-45,-29,-16,0,-45,31,47,-16,-11,-4,-1,-17
Buffalo Sabres,2014/11/02  vs. DET,DET,1,26,50,-24,-14,-3,-7,-17,24,39,-15,-7,-1,-7,-8
Buffalo Sabres,2014/12/23  vs. DET,DET,1,20,53,-33,-13,-19,-1,-27,16,37,-21,-11,-12,2,-20
Buffalo Sabres,2015/01/13  vs. DET,DET,1,26,48,-22,-2,0,-20,-12,24,31,-7,0,0,-7,-2
Buffalo Sabres,2015/01/18  vs. DET,DET,1,26,41,-15,-5,-6,-4,-8,23,25,-2,-3,2,-1,-1
Buffalo Sabres,2014/11/07  vs. EDM,EDM,1,44,77,-33,-14,-10,-9,-16,37,60,-23,-10,-7,-6,-10
Buffalo Sabres,2015/01/29  vs. EDM,EDM,1,34,63,-29,-5,-7,-17,-13,25,46,-21,-3,-5,-13,-10
Buffalo Sabres,2014/10/17  vs. FLA,FLA,1,31,50,-19,-17,0,-2,-20,25,38,-13,-13,0,0,-13
Buffalo Sabres,2014/12/06  vs. FLA,FLA,1,39,60,-21,-2,0,-19,-15,32,48,-16,-4,0,-12,-12
Buffalo Sabres,2014/12/13  vs. FLA,FLA,1,48,47,1,2,1,-2,6,39,37,2,3,3,-4,6
Buffalo Sabres,2015/01/02  vs. FLA,FLA,1,42,48,-6,-3,0,-3,-7,32,39,-7,-1,0,-6,-5
Buffalo Sabres,2015/02/28  vs. FLA,FLA,1,20,47,-27,-4,-8,-15,-3,15,37,-22,-2,-8,-12,-1
Buffalo Sabres,2014/10/23  vs. LAK,LAK,1,38,68,-30,-1,0,-29,-21,33,51,-18,-1,0,-17,-9
Buffalo Sabres,2014/12/09  vs. LAK,LAK,1,18,57,-39,-23,-16,0,-23,14,37,-23,-13,-10,0,-13
Buffalo Sabres,2014/11/13  vs. MIN,MIN,1,27,57,-30,-2,-7,-21,-13,23,41,-18,-1,-5,-12,-9
Buffalo Sabres,2015/01/15  vs. MIN,MIN,1,33,44,-11,-7,0,-4,-10,20,32,-12,-6,0,-6,-11
Buffalo Sabres,2014/11/05  vs. MTL,MTL,1,32,50,-18,-17,0,-1,-17,26,38,-12,-11,0,-1,-11
Buffalo Sabres,2014/11/28  vs. MTL,MTL,1,41,49,-8,-13,5,0,-7,28,35,-7,-9,2,0,-7
Buffalo Sabres,2014/11/29  vs. MTL,MTL,1,31,76,-45,-28,-16,-1,-44,24,52,-28,-17,-10,-1,-27
Buffalo Sabres,2015/02/03  vs. MTL,MTL,1,40,78,-38,2,-40,0,3,26,48,-22,-1,-21,0,0
Buffalo Sabres,2015/01/06  vs. NJD,NJD,1,35,45,-10,3,0,-13,-4,24,30,-6,2,0,-8,-3
Buffalo Sabres,2015/02/17  vs. NJD,NJD,1,34,42,-8,-5,0,-3,-8,26,32,-6,-5,0,-1,-6
Buffalo Sabres,2015/03/20  vs. NJD,NJD,1,47,45,2,-7,0,9,-7,34,31,3,-1,0,4,-2
Buffalo Sabres,2015/02/22  vs. NSH,NSH,1,20,58,-38,-33,-5,0,-32,14,39,-25,-22,-3,0,-21
Buffalo Sabres,2015/03/21  vs. NSH,NSH,1,36,72,-36,-30,0,-6,-31,30,60,-30,-28,0,-2,-28
Buffalo Sabres,2014/12/27  vs. NYI,NYI,1,33,44,-11,-1,0,-10,-3,21,33,-12,0,0,-12,-3
Buffalo Sabres,2015/02/08  vs. NYI,NYI,1,24,58,-34,-14,0,-20,-27,17,38,-21,-7,0,-14,-19
Buffalo Sabres,2015/04/04  vs. NYI,NYI,1,32,56,-24,-8,0,-16,-15,25,48,-23,-8,0,-15,-10
Buffalo Sabres,2015/01/03  vs. NYR,NYR,1,29,58,-29,-6,0,-23,-6,21,40,-19,-4,0,-15,-4
Buffalo Sabres,2015/02/20  vs. NYR,NYR,1,33,61,-28,-1,-8,-19,-21,28,51,-23,-3,-6,-14,-18
Buffalo Sabres,2015/03/14  vs. NYR,NYR,1,20,57,-37,-26,0,-11,-26,17,44,-27,-20,0,-7,-20
Buffalo Sabres,2014/12/15  vs. OTT,OTT,1,39,35,4,4,-2,2,-4,36,24,12,7,1,4,4
Buffalo Sabres,2014/12/29  vs. OTT,OTT,1,24,64,-40,-21,-11,-8,-31,21,44,-23,-13,-7,-3,-17
Buffalo Sabres,2015/02/10  vs. OTT,OTT,1,44,51,-7,-19,0,12,-5,39,34,5,-13,0,18,7
Buffalo Sabres,2015/03/06  vs. OTT,OTT,1,42,72,-30,-2,-30,2,-29,29,48,-19,0,-21,2,-17
Buffalo Sabres,2015/01/17  vs. PHI,PHI,1,31,52,-21,-5,-3,-13,-12,27,38,-11,-1,-1,-9,-4
Buffalo Sabres,2015/02/15  vs. PHI,PHI,1,32,57,-25,-14,0,-11,-25,27,39,-12,-9,0,-3,-14
Buffalo Sabres,2015/02/19  vs. PHI,PHI,1,35,53,-18,-16,-2,0,-18,29,36,-7,-4,-3,0,-7
Buffalo Sabres,2014/11/01  vs. PIT,PIT,1,30,49,-19,-5,0,-14,-10,16,35,-19,-3,0,-16,-9
Buffalo Sabres,2014/11/08  vs. PIT,PIT,1,32,42,-10,-2,0,-8,-6,22,40,-18,-2,0,-16,-6
Buffalo Sabres,2015/04/11  vs. PIT,PIT,1,35,65,-30,-14,0,-16,-24,25,51,-26,-13,0,-13,-19
Buffalo Sabres,2014/10/25  vs. SJS,SJS,1,32,63,-31,-11,-20,0,-11,21,36,-15,-7,-8,0,-7
Buffalo Sabres,2014/11/18  vs. SJS,SJS,1,21,42,-21,-8,-13,0,-15,15,27,-12,-5,-7,0,-11
Buffalo Sabres,2014/11/11  vs. STL,STL,1,37,39,-2,6,0,-8,3,28,25,3,6,0,-3,6
Buffalo Sabres,2015/02/05  vs. STL,STL,1,37,54,-17,-19,0,2,-15,23,39,-16,-15,0,-1,-12
Buffalo Sabres,2014/12/02  vs. TBL,TBL,1,35,58,-23,-23,0,0,-23,25,38,-13,-14,0,1,-14
Buffalo Sabres,2014/12/04  vs. TBL,TBL,1,22,52,-30,-1,0,-29,-10,16,36,-20,-2,0,-18,-6
Buffalo Sabres,2014/12/31  vs. TBL,TBL,1,26,42,-16,-4,0,-12,-6,16,30,-14,-5,0,-9,-5
Buffalo Sabres,2015/01/09  vs. TBL,TBL,1,31,67,-36,-34,0,-2,-34,20,56,-36,-31,0,-5,-34
Buffalo Sabres,2015/03/03  vs. TBL,TBL,1,41,54,-13,-2,0,-11,-8,31,38,-7,1,0,-8,-2
Buffalo Sabres,2014/10/28  vs. TOR,TOR,1,32,50,-18,-11,0,-7,-10,16,36,-20,-11,0,-9,-11
Buffalo Sabres,2014/11/15  vs. TOR,TOR,1,37,53,-16,-10,-6,0,-9,32,45,-13,-10,-3,0,-10
Buffalo Sabres,2015/03/11  vs. TOR,TOR,1,47,35,12,-2,13,1,15,38,25,13,2,11,0,14
Buffalo Sabres,2015/04/01  vs. TOR,TOR,1,33,39,-6,-1,-9,4,8,27,26,1,0,-5,6,7
Buffalo Sabres,2015/01/30  vs. VAN,VAN,1,12,58,-46,-3,-9,-34,-26,11,41,-30,-3,-5,-22,-18
Buffalo Sabres,2015/02/26  vs. VAN,VAN,1,27,52,-25,-15,-4,-6,-20,25,36,-11,-3,-2,-6,-8
Buffalo Sabres,2014/11/26  vs. WPG,WPG,1,28,33,-5,0,0,-5,-6,22,23,-1,0,0,-1,-5
Buffalo Sabres,2014/12/16  vs. WPG,WPG,1,30,52,-22,-8,-3,-11,-9,24,39,-15,-5,0,-10,-3
Buffalo Sabres,2014/11/22  vs. WSH,WSH,1,39,67,-28,-17,-11,0,-25,25,48,-23,-17,-6,0,-22
Buffalo Sabres,2015/03/07  vs. WSH,WSH,1,34,71,-37,-21,2,-18,-20,24,52,-28,-14,2,-16,-13
Buffalo Sabres,2015/03/16  vs. WSH,WSH,1,39,60,-21,-6,-9,-6,-15,32,37,-5,-1,-1,-3,-2
Calgary Flames,2014/11/18  vs. ANA,ANA,1,28,46,-18,-13,0,-5,-19,19,25,-6,-5,0,-1,-8
Calgary Flames,2014/11/25  vs. ANA,ANA,1,39,44,-5,-6,0,1,1,32,37,-5,-6,0,1,2
Calgary Flames,2015/01/21  vs. ANA,ANA,1,51,47,4,1,0,3,-1,35,33,2,0,0,2,-3
Calgary Flames,2015/02/20  vs. ANA,ANA,1,41,61,-20,-4,-14,-2,-13,24,43,-19,-3,-11,-5,-11
Calgary Flames,2015/03/11  vs. ANA,ANA,1,26,53,-27,-6,-21,0,-3,22,37,-15,-5,-12,2,-2
Calgary Flames,2014/11/13  vs. ARI,ARI,1,37,44,-7,-6,-1,0,1,27,29,-2,-6,4,0,4
Calgary Flames,2014/11/29  vs. ARI,ARI,1,44,57,-13,8,-21,0,1,28,33,-5,7,-12,0,1
Calgary Flames,2014/12/02  vs. ARI,ARI,1,35,60,-25,-14,-11,0,-16,29,37,-8,-6,-2,0,-5
Calgary Flames,2015/01/15  vs. ARI,ARI,1,46,52,-6,-6,0,0,-7,35,40,-5,-10,5,0,-11
Calgary Flames,2015/04/07  vs. ARI,ARI,1,48,55,-7,-8,1,0,-4,32,30,2,-3,5,0,2
Calgary Flames,2015/02/16  vs. BOS,BOS,1,39,43,-4,-4,0,0,-6,27,30,-3,-1,0,-2,-3
Calgary Flames,2015/03/05  vs. BOS,BOS,1,34,67,-33,-18,-4,-11,-29,29,38,-9,-8,-3,2,-6
Calgary Flames,2014/12/11  vs. BUF,BUF,1,54,33,21,16,6,-1,13,37,24,13,12,5,-4,9
Calgary Flames,2015/01/27  vs. BUF,BUF,1,54,35,19,14,6,-1,13,36,19,17,13,4,0,13
Calgary Flames,2014/10/23  vs. CAR,CAR,1,41,38,3,6,-3,0,9,30,22,8,5,3,0,8
Calgary Flames,2014/11/10  vs. CAR,CAR,1,53,58,-5,3,-5,-3,1,40,42,-2,4,-4,-2,1
Calgary Flames,2014/10/17  vs. CBJ,CBJ,1,34,38,-4,-3,0,-1,-3,24,28,-4,-2,0,-2,-3
Calgary Flames,2015/03/21  vs. CBJ,CBJ,1,53,44,9,13,-4,0,14,41,30,11,11,0,0,14
Calgary Flames,2014/10/15  vs. CHI,CHI,1,27,74,-47,-32,-15,0,-36,16,47,-31,-25,-6,0,-25
Calgary Flames,2014/11/20  vs. CHI,CHI,1,32,42,-10,-8,0,-2,-15,18,29,-11,-6,0,-5,-11
Calgary Flames,2014/12/14  vs. CHI,CHI,1,35,67,-32,-31,-2,1,-33,29,47,-18,-16,-2,0,-18
Calgary Flames,2014/12/04  vs. COL,COL,1,46,47,-1,-5,-3,7,-3,32,32,0,2,-5,3,0
Calgary Flames,2015/03/14  vs. COL,COL,1,51,48,3,7,0,-4,8,30,34,-4,3,0,-7,3
Calgary Flames,2015/03/23  vs. COL,COL,1,49,45,4,3,1,0,6,34,35,-1,0,-1,0,1
Calgary Flames,2014/12/19  vs. DAL,DAL,1,26,52,-26,-10,0,-16,-12,20,32,-12,0,0,-12,-2
Calgary Flames,2015/03/25  vs. DAL,DAL,1,34,35,-1,-9,0,8,-3,25,21,4,-1,0,5,2
Calgary Flames,2015/03/30  vs. DAL,DAL,1,34,79,-45,3,-29,-19,-13,28,54,-26,2,-22,-6,-1
Calgary Flames,2015/01/07  vs. DET,DET,1,34,44,-10,-9,0,-1,-9,28,31,-3,-9,3,3,-6
Calgary Flames,2015/03/06  vs. DET,DET,1,28,57,-29,-3,-10,-16,-27,24,37,-13,-2,-5,-6,-16
Calgary Flames,2014/10/09  vs. EDM,EDM,1,34,66,-32,-12,-20,0,-28,28,48,-20,-8,-12,0,-20
Calgary Flames,2014/12/27  vs. EDM,EDM,1,41,47,-6,-1,-5,0,3,23,33,-10,-2,-8,0,0
Calgary Flames,2014/12/31  vs. EDM,EDM,1,40,39,1,7,0,-6,-2,24,24,0,1,0,-1,-3
Calgary Flames,2015/01/31  vs. EDM,EDM,1,59,46,13,6,-4,11,4,45,28,17,5,0,12,4
Calgary Flames,2015/04/04  vs. EDM,EDM,1,56,66,-10,-3,-7,0,-14,39,49,-10,-2,-8,0,-10
Calgary Flames,2014/11/08  vs. FLA,FLA,1,33,49,-16,-6,1,-11,-11,26,38,-12,-4,0,-8,-7
Calgary Flames,2015/01/09  vs. FLA,FLA,1,39,58,-19,-15,0,-4,-17,26,46,-20,-15,1,-6,-17
Calgary Flames,2014/12/22  vs. LAK,LAK,1,45,65,-20,1,0,-21,-7,30,41,-11,1,0,-12,-4
Calgary Flames,2014/12/29  vs. LAK,LAK,1,31,57,-26,3,-29,0,1,20,37,-17,-1,-16,0,-3
Calgary Flames,2015/01/19  vs. LAK,LAK,1,29,46,-17,-17,0,0,-17,19,31,-12,-10,0,-2,-10
Calgary Flames,2015/02/12  vs. LAK,LAK,1,33,74,-41,-6,-9,-26,-33,19,53,-34,-4,-9,-21,-26
Calgary Flames,2015/04/09  vs. LAK,LAK,1,37,67,-30,-3,-27,0,-4,30,43,-13,3,-16,0,3
Calgary Flames,2015/01/29  vs. MIN,MIN,1,57,55,2,4,0,-2,4,38,40,-2,1,0,-3,-2
Calgary Flames,2015/02/18  vs. MIN,MIN,1,55,51,4,0,0,4,7,41,31,10,5,0,5,14
Calgary Flames,2015/03/27  vs. MIN,MIN,1,40,57,-17,-16,-7,6,-23,32,42,-10,-8,-6,4,-14
Calgary Flames,2014/10/28  vs. MTL,MTL,1,40,33,7,7,0,0,7,30,20,10,8,2,0,10
Calgary Flames,2014/11/02  vs. MTL,MTL,1,39,44,-5,-2,-3,0,10,29,23,6,-1,7,0,9
Calgary Flames,2014/11/22  vs. NJD,NJD,1,34,46,-12,0,0,-12,-3,27,29,-2,1,0,-3,3
Calgary Flames,2015/02/25  vs. NJD,NJD,1,41,28,13,7,7,-1,6,32,21,11,4,6,1,5
Calgary Flames,2014/10/14  vs. NSH,NSH,1,50,37,13,10,5,-2,13,30,25,5,7,0,-2,5
Calgary Flames,2014/10/31  vs. NSH,NSH,1,44,81,-37,-23,-13,-1,-26,34,47,-13,-11,-2,0,-11
Calgary Flames,2015/03/29  vs. NSH,NSH,1,54,50,4,4,1,-1,7,39,34,5,4,4,-3,5
Calgary Flames,2015/01/02  vs. NYI,NYI,1,32,56,-24,-10,0,-14,-19,22,33,-11,-6,0,-5,-7
Calgary Flames,2015/02/27  vs. NYI,NYI,1,44,56,-12,-5,0,-7,-6,27,40,-13,-6,0,-7,-5
Calgary Flames,2014/12/16  vs. NYR,NYR,1,45,30,15,2,0,13,2,28,22,6,1,0,5,1
Calgary Flames,2015/02/24  vs. NYR,NYR,1,36,53,-17,-13,0,-4,-13,28,36,-8,-4,0,-4,-4
Calgary Flames,2014/11/15  vs. OTT,OTT,1,43,35,8,8,-5,5,13,33,22,11,5,-1,7,12
Calgary Flames,2015/03/08  vs. OTT,OTT,1,53,61,-8,-3,0,-5,-7,40,44,-4,0,0,-4,-6
Calgary Flames,2015/03/03  vs. PHI,PHI,1,45,74,-29,-14,-15,0,-16,35,47,-12,-6,-6,0,-7
Calgary Flames,2015/03/19  vs. PHI,PHI,1,42,47,-5,1,-6,0,1,27,30,-3,-3,0,0,-3
Calgary Flames,2014/12/12  vs. PIT,PIT,1,25,33,-8,-1,0,-7,-11,22,26,-4,0,0,-4,-9
Calgary Flames,2015/02/06  vs. PIT,PIT,1,29,46,-17,-7,0,-10,-6,21,40,-19,-6,0,-13,-7
Calgary Flames,2014/11/26  vs. SJS,SJS,1,36,61,-25,-10,-15,0,-8,23,34,-11,-1,-10,0,-2
Calgary Flames,2014/12/06  vs. SJS,SJS,1,63,51,12,9,-3,6,15,46,40,6,9,-4,1,9
Calgary Flames,2015/01/17  vs. SJS,SJS,1,49,47,2,3,-4,3,5,28,28,0,-1,0,1,2
Calgary Flames,2015/02/04  vs. SJS,SJS,1,32,46,-14,-5,-9,0,-8,26,35,-9,-4,-5,0,-7
Calgary Flames,2015/02/09  vs. SJS,SJS,1,39,54,-15,0,-15,0,-3,29,38,-9,-1,-8,0,-2
Calgary Flames,2014/10/11  vs. STL,STL,1,35,47,-12,0,0,-12,-5,26,36,-10,0,0,-10,-3
Calgary Flames,2015/03/17  vs. STL,STL,1,51,55,-4,-6,0,2,-4,33,37,-4,-6,0,2,-4
Calgary Flames,2015/04/02  vs. STL,STL,1,30,59,-29,0,0,-29,-22,21,46,-25,0,0,-25,-22
Calgary Flames,2014/10/21  vs. TBL,TBL,1,32,44,-12,-4,-8,0,-4,25,27,-2,1,-3,0,1
Calgary Flames,2014/11/06  vs. TBL,TBL,1,39,53,-14,4,0,-18,-1,26,41,-15,3,0,-18,-3
Calgary Flames,2014/12/09  vs. TOR,TOR,1,64,42,22,5,0,17,7,38,32,6,1,0,5,1
Calgary Flames,2015/03/13  vs. TOR,TOR,1,36,47,-11,2,-13,0,6,29,26,3,5,-2,0,9
Calgary Flames,2014/10/08  vs. VAN,VAN,1,38,41,-3,4,0,-7,-8,28,31,-3,2,0,-5,-7
Calgary Flames,2014/12/20  vs. VAN,VAN,1,45,54,-9,-3,0,-6,-3,30,38,-8,-3,0,-5,-1
Calgary Flames,2015/01/10  vs. VAN,VAN,1,38,73,-35,-9,-26,0,-23,25,51,-26,-8,-18,0,-22
Calgary Flames,2015/02/14  vs. VAN,VAN,1,45,50,-5,-1,-2,-2,-4,38,34,4,3,3,-2,3
Calgary Flames,2014/10/19  vs. WPG,WPG,1,39,58,-19,-5,-13,-1,-3,34,40,-6,-5,-5,4,2
Calgary Flames,2015/02/02  vs. WPG,WPG,1,36,54,-18,-3,-11,-4,-11,29,35,-6,0,-5,-1,-6
Calgary Flames,2015/04/11  vs. WPG,WPG,1,41,33,8,12,1,-5,13,31,22,9,9,1,-1,10
Calgary Flames,2014/10/25  vs. WSH,WSH,1,35,40,-5,-6,0,1,-3,25,32,-7,-6,0,-1,-6
Calgary Flames,2014/11/04  vs. WSH,WSH,1,43,56,-13,-12,1,-2,-12,28,37,-9,-8,2,-3,-7
Carolina Hurricanes,2015/02/03  vs. ANA,ANA,1,34,40,-6,-6,-3,3,-3,29,31,-2,-6,0,4,-2
Carolina Hurricanes,2015/02/12  vs. ANA,ANA,1,59,33,26,23,1,2,20,44,24,20,17,2,1,15
Carolina Hurricanes,2014/11/01  vs. ARI,ARI,1,44,35,9,5,4,0,5,34,24,10,3,7,0,3
Carolina Hurricanes,2015/02/05  vs. ARI,ARI,1,49,49,0,5,-5,0,0,37,36,1,5,-4,0,1
Carolina Hurricanes,2014/11/15  vs. BOS,BOS,1,45,39,6,1,3,2,-4,36,30,6,1,4,1,-5
Carolina Hurricanes,2015/01/04  vs. BOS,BOS,1,56,44,12,14,-2,0,12,47,31,16,17,-1,0,16
Carolina Hurricanes,2015/03/29  vs. BOS,BOS,1,57,37,20,6,0,14,20,49,33,16,7,0,9,16
Carolina Hurricanes,2014/10/14  vs. BUF,BUF,1,55,24,31,7,0,24,15,42,18,24,10,0,14,10
Carolina Hurricanes,2015/01/08  vs. BUF,BUF,1,57,31,26,17,9,0,17,35,26,9,7,2,0,8
Carolina Hurricanes,2015/04/06  vs. BUF,BUF,1,79,31,48,0,0,48,14,62,30,32,0,0,32,9
Carolina Hurricanes,2014/11/04  vs. CBJ,CBJ,1,31,30,1,2,-1,0,7,26,22,4,1,3,0,4
Carolina Hurricanes,2014/11/07  vs. CBJ,CBJ,1,52,36,16,5,3,8,10,35,26,9,2,2,5,6
Carolina Hurricanes,2015/03/10  vs. CBJ,CBJ,1,47,43,4,-1,5,0,8,35,33,2,1,1,0,9
Carolina Hurricanes,2015/03/15  vs. CBJ,CBJ,1,30,37,-7,2,-11,2,7,26,27,-1,2,-5,2,7
Carolina Hurricanes,2014/10/23  vs. CGY,CGY,1,38,41,-3,-6,0,3,-9,22,30,-8,-5,0,-3,-8
Carolina Hurricanes,2014/11/10  vs. CGY,CGY,1,58,53,5,-3,3,5,-1,42,40,2,-4,2,4,-1
Carolina Hurricanes,2015/03/02  vs. CHI,CHI,1,46,52,-6,-5,0,-1,-6,33,33,0,-1,0,1,-4
Carolina Hurricanes,2015/03/23  vs. CHI,CHI,1,74,45,29,-2,0,31,10,53,36,17,-1,0,18,9
Carolina Hurricanes,2014/11/22  vs. COL,COL,1,49,46,3,0,4,-1,-3,34,33,1,-2,4,-1,-4
Carolina Hurricanes,2015/01/13  vs. COL,COL,1,87,57,30,20,10,0,28,62,39,23,18,5,0,21
Carolina Hurricanes,2014/11/18  vs. DAL,DAL,1,44,39,5,2,-16,19,16,33,32,1,2,-13,12,9
Carolina Hurricanes,2015/03/12  vs. DAL,DAL,1,45,51,-6,0,-2,-4,1,27,39,-12,-1,-3,-8,-2
Carolina Hurricanes,2014/12/07  vs. DET,DET,1,41,26,15,4,0,11,2,29,20,9,1,0,8,-1
Carolina Hurricanes,2015/04/07  vs. DET,DET,1,44,38,6,0,1,5,1,39,29,10,1,1,8,5
Carolina Hurricanes,2015/04/11  vs. DET,DET,1,49,53,-4,-2,0,-2,-9,40,33,7,0,0,7,4
Carolina Hurricanes,2014/10/24  vs. EDM,EDM,1,50,47,3,-1,0,4,-2,38,32,6,4,0,2,4
Carolina Hurricanes,2015/03/08  vs. EDM,EDM,1,55,26,29,13,-1,17,25,39,16,23,8,2,13,16
Carolina Hurricanes,2014/11/26  vs. FLA,FLA,1,42,48,-6,-2,0,-4,-18,32,35,-3,-2,0,-1,-12
Carolina Hurricanes,2015/03/14  vs. FLA,FLA,1,43,38,5,-2,0,7,1,32,25,7,0,0,7,3
Carolina Hurricanes,2015/04/02  vs. FLA,FLA,1,44,56,-12,6,0,-18,1,36,47,-11,6,0,-17,1
Carolina Hurricanes,2014/11/02  vs. LAK,LAK,1,46,44,2,7,-5,0,14,36,33,3,1,2,0,10
Carolina Hurricanes,2014/11/20  vs. LAK,LAK,1,39,53,-14,-4,0,-10,-15,31,40,-9,-4,0,-5,-9
Carolina Hurricanes,2015/02/14  vs. MIN,MIN,1,52,31,21,1,0,20,10,36,27,9,1,0,8,9
Carolina Hurricanes,2015/03/06  vs. MIN,MIN,1,67,29,38,13,0,25,20,42,26,16,7,0,9,6
Carolina Hurricanes,2014/12/16  vs. MTL,MTL,1,44,37,7,0,0,7,0,32,27,5,-5,0,10,-3
Carolina Hurricanes,2014/12/29  vs. MTL,MTL,1,43,32,11,1,0,10,8,29,25,4,-3,0,7,1
Carolina Hurricanes,2015/03/19  vs. MTL,MTL,1,48,40,8,-2,0,10,-7,33,23,10,-1,0,11,-5
Carolina Hurricanes,2014/12/08  vs. NJD,NJD,1,63,38,25,-3,1,27,-2,43,26,17,-2,4,15,2
Carolina Hurricanes,2014/12/23  vs. NJD,NJD,1,41,29,12,-3,0,15,5,32,21,11,-1,0,12,7
Carolina Hurricanes,2015/02/21  vs. NJD,NJD,1,39,24,15,5,0,10,5,33,22,11,2,0,9,2
Carolina Hurricanes,2015/03/28  vs. NJD,NJD,1,55,42,13,16,2,-5,11,41,29,12,12,1,-1,11
Carolina Hurricanes,2014/12/02  vs. NSH,NSH,1,54,53,1,4,-3,0,12,33,41,-8,-3,-5,0,2
Carolina Hurricanes,2015/01/06  vs. NSH,NSH,1,42,48,-6,2,-10,2,-3,28,37,-9,0,-10,1,-5
Carolina Hurricanes,2014/10/10  vs. NYI,NYI,1,38,43,-5,-3,0,-2,-3,28,33,-5,-3,0,-2,-3
Carolina Hurricanes,2014/10/11  vs. NYI,NYI,1,30,43,-13,-4,0,-9,-8,21,34,-13,-3,0,-10,-8
Carolina Hurricanes,2015/02/17  vs. NYI,NYI,1,73,55,18,-12,0,30,-6,52,41,11,-11,0,22,-6
Carolina Hurricanes,2015/02/28  vs. NYI,NYI,1,57,39,18,16,3,-1,13,41,29,12,11,1,0,8
Carolina Hurricanes,2014/10/16  vs. NYR,NYR,1,29,45,-16,-15,-1,0,-13,24,30,-6,-6,0,0,-4
Carolina Hurricanes,2014/12/20  vs. NYR,NYR,1,32,61,-29,-7,-22,0,-19,25,46,-21,-7,-14,0,-12
Carolina Hurricanes,2014/12/21  vs. NYR,NYR,1,24,44,-20,-3,0,-17,-14,18,31,-13,-2,0,-11,-10
Carolina Hurricanes,2015/01/31  vs. NYR,NYR,1,52,53,-1,6,0,-7,-2,37,42,-5,3,0,-8,-3
Carolina Hurricanes,2015/03/21  vs. NYR,NYR,1,65,42,23,8,6,9,11,42,33,9,0,5,4,1
Carolina Hurricanes,2015/01/17  vs. OTT,OTT,1,39,61,-22,-13,-8,-1,-19,31,43,-12,-5,-6,-1,-9
Carolina Hurricanes,2015/02/16  vs. OTT,OTT,1,44,61,-17,-7,-10,0,-9,35,44,-9,-2,-7,0,-2
Carolina Hurricanes,2015/03/17  vs. OTT,OTT,1,47,43,4,13,-9,0,4,39,32,7,15,-8,0,7
Carolina Hurricanes,2014/12/13  vs. PHI,PHI,1,55,44,11,-1,0,12,1,35,32,3,-1,0,4,1
Carolina Hurricanes,2015/01/02  vs. PHI,PHI,1,42,40,2,7,-5,0,14,32,32,0,5,-5,0,10
Carolina Hurricanes,2015/02/24  vs. PHI,PHI,1,52,44,8,2,6,0,13,36,30,6,1,5,0,8
Carolina Hurricanes,2015/04/04  vs. PHI,PHI,1,41,36,5,3,2,0,7,29,26,3,1,2,0,4
Carolina Hurricanes,2015/04/09  vs. PHI,PHI,1,36,37,-1,0,-1,0,-4,26,28,-2,0,-2,0,-3
Carolina Hurricanes,2014/11/28  vs. PIT,PIT,1,52,33,19,14,5,0,20,38,25,13,9,4,0,14
Carolina Hurricanes,2014/11/29  vs. PIT,PIT,1,38,38,0,-2,1,1,1,25,30,-5,-2,0,-3,-2
Carolina Hurricanes,2014/12/31  vs. PIT,PIT,1,35,57,-22,-14,-7,-1,-21,25,36,-11,-7,-3,-1,-10
Carolina Hurricanes,2015/03/26  vs. PIT,PIT,1,36,39,-3,-5,2,0,2,24,33,-9,-5,-4,0,-5
Carolina Hurricanes,2014/11/16  vs. SJS,SJS,1,80,36,44,19,0,25,27,62,22,40,17,0,23,24
Carolina Hurricanes,2015/02/07  vs. SJS,SJS,1,48,43,5,5,0,0,10,36,36,0,2,-2,0,5
Carolina Hurricanes,2015/01/10  vs. STL,STL,1,42,40,2,6,-4,0,7,36,37,-1,6,-7,0,4
Carolina Hurricanes,2015/01/30  vs. STL,STL,1,48,65,-17,-11,0,-6,-11,34,42,-8,-10,0,2,-5
Carolina Hurricanes,2014/12/11  vs. TBL,TBL,1,32,46,-14,-14,0,0,-14,27,34,-7,-8,0,1,-8
Carolina Hurricanes,2014/12/27  vs. TBL,TBL,1,29,55,-26,-1,0,-25,-24,26,40,-14,1,0,-15,-16
Carolina Hurricanes,2015/01/27  vs. TBL,TBL,1,28,48,-20,0,-20,0,-9,20,37,-17,0,-17,0,-6
Carolina Hurricanes,2014/12/18  vs. TOR,TOR,1,52,38,14,14,0,0,13,39,31,8,10,-2,0,9
Carolina Hurricanes,2015/01/19  vs. TOR,TOR,1,35,43,-8,-4,-4,0,-6,30,34,-4,-2,-2,0,-4
Carolina Hurricanes,2015/02/20  vs. TOR,TOR,1,46,49,-3,0,-3,0,-1,31,33,-2,0,-2,0,-1
Carolina Hurricanes,2014/10/28  vs. VAN,VAN,1,40,38,2,1,0,1,-6,30,30,0,1,0,-1,-6
Carolina Hurricanes,2015/01/16  vs. VAN,VAN,1,48,32,16,7,0,9,10,35,23,12,7,0,5,9
Carolina Hurricanes,2014/10/21  vs. WPG,WPG,1,33,36,-3,-2,0,-1,-7,24,29,-5,-1,0,-4,-6
Carolina Hurricanes,2014/11/13  vs. WPG,WPG,1,55,60,-5,-2,0,-3,-11,40,47,-7,-4,0,-3,-11
Carolina Hurricanes,2014/11/08  vs. WSH,WSH,1,48,54,-6,-2,0,-4,-6,30,35,-5,-8,0,3,-6
Carolina Hurricanes,2014/12/04  vs. WSH,WSH,1,54,58,-4,-2,0,-2,-4,33,34,-1,2,0,-3,0
Carolina Hurricanes,2015/02/27  vs. WSH,WSH,1,53,47,6,3,3,0,3,38,33,5,1,4,0,-1
Carolina Hurricanes,2015/03/31  vs. WSH,WSH,1,42,41,1,0,0,1,-1,30,30,0,1,0,-1,-1
Chicago Blackhawks,2014/10/28  vs. ANA,ANA,1,52,36,16,11,0,5,11,39,27,12,7,0,5,7
Chicago Blackhawks,2014/11/28  vs. ANA,ANA,1,45,28,17,5,12,0,11,39,24,15,4,11,0,10
Chicago Blackhawks,2015/01/30  vs. ANA,ANA,1,54,36,18,6,12,0,22,41,29,12,4,8,0,14
Chicago Blackhawks,2015/01/20  vs. ARI,ARI,1,62,42,20,-3,23,0,7,48,33,15,-3,18,0,7
Chicago Blackhawks,2015/02/09  vs. ARI,ARI,1,54,50,4,2,1,1,3,39,33,6,2,3,1,5
Chicago Blackhawks,2015/03/12  vs. ARI,ARI,1,50,31,19,16,0,3,19,34,25,9,10,-3,2,12
Chicago Blackhawks,2014/12/11  vs. BOS,BOS,1,35,51,-16,-3,-13,0,-1,30,41,-11,-3,-8,0,-1
Chicago Blackhawks,2015/02/22  vs. BOS,BOS,1,43,38,5,-3,0,8,2,27,30,-3,-1,0,-2,1
Chicago Blackhawks,2014/10/11  vs. BUF,BUF,1,60,25,35,15,20,0,24,48,20,28,10,18,0,17
Chicago Blackhawks,2015/04/03  vs. BUF,BUF,1,45,34,11,4,3,4,6,31,27,4,4,-3,3,4
Chicago Blackhawks,2015/03/02  vs. CAR,CAR,1,52,46,6,5,1,0,6,33,33,0,1,-1,0,4
Chicago Blackhawks,2015/03/23  vs. CAR,CAR,1,45,74,-29,2,-31,0,-10,36,53,-17,1,-18,0,-9
Chicago Blackhawks,2014/12/20  vs. CBJ,CBJ,1,49,31,18,11,0,7,15,43,20,23,17,0,6,22
Chicago Blackhawks,2015/03/27  vs. CBJ,CBJ,1,38,32,6,-4,0,10,-6,29,25,4,-3,0,7,-4
Chicago Blackhawks,2014/10/15  vs. CGY,CGY,1,74,27,47,32,0,15,36,47,16,31,25,0,6,25
Chicago Blackhawks,2014/11/20  vs. CGY,CGY,1,42,32,10,8,2,0,15,29,18,11,6,5,0,11
Chicago Blackhawks,2014/12/14  vs. CGY,CGY,1,67,35,32,31,-1,2,33,47,29,18,16,0,2,18
Chicago Blackhawks,2014/11/26  vs. COL,COL,1,53,42,11,19,-7,-1,19,39,32,7,10,-3,0,11
Chicago Blackhawks,2014/12/27  vs. COL,COL,1,55,37,18,8,3,7,19,42,26,16,9,5,2,15
Chicago Blackhawks,2015/01/06  vs. COL,COL,1,69,37,32,0,0,32,-2,51,25,26,1,0,25,-1
Chicago Blackhawks,2015/02/20  vs. COL,COL,1,53,36,17,10,0,7,17,29,31,-2,3,0,-5,1
Chicago Blackhawks,2015/04/11  vs. COL,COL,1,51,36,15,1,0,14,16,42,26,16,3,0,13,14
Chicago Blackhawks,2014/10/09  vs. DAL,DAL,1,42,48,-6,-7,-4,5,-14,26,36,-10,-11,0,1,-15
Chicago Blackhawks,2014/11/16  vs. DAL,DAL,1,61,39,22,2,17,3,7,47,29,18,2,12,4,8
Chicago Blackhawks,2015/01/04  vs. DAL,DAL,1,56,45,11,10,0,1,8,37,34,3,9,0,-6,3
Chicago Blackhawks,2015/01/18  vs. DAL,DAL,1,67,44,23,27,0,-4,24,49,36,13,18,0,-5,18
Chicago Blackhawks,2015/03/21  vs. DAL,DAL,1,55,36,19,0,0,19,3,38,30,8,0,0,8,1
Chicago Blackhawks,2014/11/14  vs. DET,DET,1,43,41,2,-6,0,8,-6,31,34,-3,-5,0,2,-7
Chicago Blackhawks,2015/02/18  vs. DET,DET,1,49,45,4,5,0,-1,4,34,29,5,6,0,-1,5
Chicago Blackhawks,2014/11/22  vs. EDM,EDM,1,35,39,-4,-2,-2,0,-4,26,26,0,-2,2,0,-4
Chicago Blackhawks,2015/01/09  vs. EDM,EDM,1,46,41,5,-7,2,10,0,27,25,2,-4,2,4,1
Chicago Blackhawks,2015/03/06  vs. EDM,EDM,1,71,64,7,2,0,5,-4,51,48,3,0,0,3,-2
Chicago Blackhawks,2015/02/24  vs. FLA,FLA,1,47,39,8,5,3,0,9,35,29,6,3,3,0,8
Chicago Blackhawks,2015/02/26  vs. FLA,FLA,1,33,39,-6,0,-6,0,5,24,26,-2,-2,0,0,1
Chicago Blackhawks,2014/11/29  vs. LAK,LAK,1,39,45,-6,3,-9,0,6,34,35,-1,2,-3,0,6
Chicago Blackhawks,2015/01/28  vs. LAK,LAK,1,41,39,2,1,1,0,0,32,34,-2,1,-3,0,-1
Chicago Blackhawks,2015/03/30  vs. LAK,LAK,1,54,44,10,5,5,0,14,42,33,9,4,5,0,9
Chicago Blackhawks,2014/12/16  vs. MIN,MIN,1,46,41,5,10,-2,-3,11,37,26,11,10,3,-2,13
Chicago Blackhawks,2015/01/08  vs. MIN,MIN,1,23,60,-37,-3,-34,0,-19,18,42,-24,-2,-22,0,-14
Chicago Blackhawks,2015/01/11  vs. MIN,MIN,1,55,52,3,4,-1,0,6,39,41,-2,4,-6,0,6
Chicago Blackhawks,2015/02/03  vs. MIN,MIN,1,40,53,-13,-2,0,-11,-3,31,40,-9,-2,0,-7,-4
Chicago Blackhawks,2015/04/07  vs. MIN,MIN,1,53,53,0,2,0,-2,2,36,44,-8,-5,0,-3,-5
Chicago Blackhawks,2014/11/04  vs. MTL,MTL,1,52,39,13,-4,17,0,-4,33,28,5,-3,8,0,-5
Chicago Blackhawks,2014/12/05  vs. MTL,MTL,1,49,51,-2,-6,5,-1,-3,32,42,-10,-12,2,0,-11
Chicago Blackhawks,2014/12/09  vs. NJD,NJD,1,53,33,20,16,0,4,16,41,26,15,11,0,4,12
Chicago Blackhawks,2015/02/13  vs. NJD,NJD,1,53,41,12,-4,11,5,1,38,27,11,-4,10,5,1
Chicago Blackhawks,2014/10/18  vs. NSH,NSH,1,44,39,5,3,2,0,5,32,24,8,7,1,0,8
Chicago Blackhawks,2014/10/23  vs. NSH,NSH,1,46,48,-2,-9,-2,9,-14,33,37,-4,-9,-1,6,-13
Chicago Blackhawks,2014/12/06  vs. NSH,NSH,1,47,51,-4,3,-7,0,0,36,40,-4,1,-5,0,-2
Chicago Blackhawks,2014/12/29  vs. NSH,NSH,1,50,43,7,-8,0,15,-5,36,35,1,-8,0,9,-8
Chicago Blackhawks,2014/12/13  vs. NYI,NYI,1,43,58,-15,-6,-1,-8,-5,26,46,-20,-14,1,-7,-13
Chicago Blackhawks,2015/03/17  vs. NYI,NYI,1,50,55,-5,6,-11,0,8,39,43,-4,4,-8,0,9
Chicago Blackhawks,2015/03/08  vs. NYR,NYR,1,51,42,9,9,0,0,9,35,36,-1,-1,0,0,-1
Chicago Blackhawks,2015/03/18  vs. NYR,NYR,1,47,42,5,6,-1,0,6,39,32,7,6,1,0,6
Chicago Blackhawks,2014/10/26  vs. OTT,OTT,1,41,41,0,9,-9,0,8,35,30,5,9,-4,0,12
Chicago Blackhawks,2014/10/30  vs. OTT,OTT,1,43,41,2,2,4,-4,3,32,30,2,4,3,-5,5
Chicago Blackhawks,2014/10/21  vs. PHI,PHI,1,52,46,6,6,0,0,9,43,33,10,7,3,0,10
Chicago Blackhawks,2015/03/25  vs. PHI,PHI,1,59,55,4,0,0,4,1,45,41,4,1,0,3,3
Chicago Blackhawks,2015/01/21  vs. PIT,PIT,1,43,48,-5,-6,1,0,-4,33,38,-5,-3,-2,0,-5
Chicago Blackhawks,2015/02/15  vs. PIT,PIT,1,46,47,-1,0,-1,0,-3,37,36,1,-2,3,0,-1
Chicago Blackhawks,2014/11/09  vs. SJS,SJS,1,47,44,3,-3,6,0,-2,38,32,6,2,4,0,1
Chicago Blackhawks,2015/01/31  vs. SJS,SJS,1,37,36,1,-3,0,4,4,26,25,1,-1,0,2,4
Chicago Blackhawks,2015/03/14  vs. SJS,SJS,1,40,49,-9,-18,9,0,-16,27,37,-10,-17,7,0,-15
Chicago Blackhawks,2014/10/25  vs. STL,STL,1,42,40,2,7,-6,1,-3,29,35,-6,2,-6,-2,-7
Chicago Blackhawks,2014/12/03  vs. STL,STL,1,49,36,13,6,7,0,6,34,29,5,-1,6,0,-2
Chicago Blackhawks,2015/02/08  vs. STL,STL,1,47,46,1,1,0,0,-5,29,35,-6,-4,-2,0,-10
Chicago Blackhawks,2015/04/05  vs. STL,STL,1,65,37,28,7,0,21,11,43,29,14,1,2,11,7
Chicago Blackhawks,2015/04/09  vs. STL,STL,1,41,32,9,8,0,1,6,24,22,2,2,0,0,0
Chicago Blackhawks,2014/11/11  vs. TBL,TBL,1,41,37,4,7,-7,4,11,28,27,1,0,-4,5,5
Chicago Blackhawks,2015/02/27  vs. TBL,TBL,1,33,41,-8,-7,0,-1,-12,23,30,-7,-5,0,-2,-10
Chicago Blackhawks,2014/11/01  vs. TOR,TOR,1,56,37,19,13,-2,8,11,43,30,13,5,0,8,4
Chicago Blackhawks,2014/12/21  vs. TOR,TOR,1,46,46,0,7,-7,0,8,35,33,2,7,-5,0,5
Chicago Blackhawks,2014/11/23  vs. VAN,VAN,1,38,51,-13,-14,0,1,-19,26,38,-12,-8,0,-4,-13
Chicago Blackhawks,2015/02/11  vs. VAN,VAN,1,56,51,5,-7,-1,13,-9,38,40,-2,-8,2,4,-9
Chicago Blackhawks,2015/04/02  vs. VAN,VAN,1,44,45,-1,6,-7,0,6,34,33,1,4,-3,0,8
Chicago Blackhawks,2014/11/02  vs. WPG,WPG,1,67,38,29,-1,0,30,16,40,29,11,-1,0,12,6
Chicago Blackhawks,2014/12/23  vs. WPG,WPG,1,62,49,13,-8,0,21,-10,45,32,13,-5,0,18,-7
Chicago Blackhawks,2015/01/16  vs. WPG,WPG,1,43,41,2,-2,-2,6,-4,27,33,-6,-7,-1,2,-8
Chicago Blackhawks,2015/02/06  vs. WPG,WPG,1,41,37,4,1,0,3,4,30,25,5,6,0,-1,5
Chicago Blackhawks,2015/03/29  vs. WPG,WPG,1,45,38,7,4,4,-1,8,28,31,-3,-3,2,-2,-1
Chicago Blackhawks,2014/11/07  vs. WSH,WSH,1,53,27,26,9,7,10,6,39,24,15,5,4,6,4
Chicago Blackhawks,2015/01/01  vs. WSH,WSH,1,42,44,-2,0,0,-2,-1,34,38,-4,-2,0,-2,-3
Colorado Avalanche,2014/11/02  vs. ANA,ANA,1,28,35,-7,-4,-1,-2,-10,21,26,-5,-1,-1,-3,-5
Colorado Avalanche,2015/03/20  vs. ANA,ANA,1,32,58,-26,-8,-1,-17,-19,25,45,-20,-8,-1,-11,-13
Colorado Avalanche,2015/04/03  vs. ANA,ANA,1,33,51,-18,-11,-3,-4,-14,27,41,-14,-7,-2,-5,-11
Colorado Avalanche,2014/11/25  vs. ARI,ARI,1,50,49,1,2,0,-1,0,36,42,-6,0,0,-6,-3
Colorado Avalanche,2015/02/16  vs. ARI,ARI,1,41,41,0,-2,2,0,2,38,25,13,-1,14,0,5
Colorado Avalanche,2015/03/19  vs. ARI,ARI,1,40,55,-15,-5,-5,-5,-13,31,46,-15,-4,-8,-3,-9
Colorado Avalanche,2014/10/13  vs. BOS,BOS,1,36,44,-8,-11,3,0,-9,28,34,-6,-8,2,0,-7
Colorado Avalanche,2015/01/21  vs. BOS,BOS,1,44,45,-1,4,-9,4,-5,23,33,-10,-6,-6,2,-12
Colorado Avalanche,2014/12/20  vs. BUF,BUF,1,36,38,-2,0,-2,0,1,24,28,-4,-1,-3,0,-1
Colorado Avalanche,2015/03/28  vs. BUF,BUF,1,38,45,-7,6,-13,0,7,31,30,1,6,-5,0,7
Colorado Avalanche,2014/11/22  vs. CAR,CAR,1,46,49,-3,0,1,-4,3,33,34,-1,2,1,-4,4
Colorado Avalanche,2015/01/13  vs. CAR,CAR,1,57,87,-30,-20,0,-10,-28,39,62,-23,-18,0,-5,-21
Colorado Avalanche,2015/01/04  vs. CBJ,CBJ,1,38,47,-9,-11,-4,6,-8,30,35,-5,-7,-3,5,-4
Colorado Avalanche,2015/03/07  vs. CBJ,CBJ,1,25,58,-33,-1,-32,0,-1,21,46,-25,-1,-24,0,-1
Colorado Avalanche,2014/12/04  vs. CGY,CGY,1,47,46,1,5,-7,3,3,32,32,0,-2,-3,5,0
Colorado Avalanche,2015/03/14  vs. CGY,CGY,1,48,51,-3,-7,4,0,-8,34,30,4,-3,7,0,-3
Colorado Avalanche,2015/03/23  vs. CGY,CGY,1,45,49,-4,-3,0,-1,-6,35,34,1,0,0,1,-1
Colorado Avalanche,2014/11/26  vs. CHI,CHI,1,42,53,-11,-19,1,7,-19,32,39,-7,-10,0,3,-11
Colorado Avalanche,2014/12/27  vs. CHI,CHI,1,37,55,-18,-8,-7,-3,-19,26,42,-16,-9,-2,-5,-15
Colorado Avalanche,2015/01/06  vs. CHI,CHI,1,37,69,-32,0,-32,0,2,25,51,-26,-1,-25,0,1
Colorado Avalanche,2015/02/20  vs. CHI,CHI,1,36,53,-17,-10,-7,0,-17,31,29,2,-3,5,0,-1
Colorado Avalanche,2015/04/11  vs. CHI,CHI,1,36,51,-15,-1,-14,0,-16,26,42,-16,-3,-13,0,-14
Colorado Avalanche,2014/11/29  vs. DAL,DAL,1,45,47,-2,2,-4,0,7,37,35,2,6,-4,0,10
Colorado Avalanche,2015/01/10  vs. DAL,DAL,1,35,57,-22,-5,-8,-9,-3,33,38,-5,-2,-4,1,2
Colorado Avalanche,2015/02/03  vs. DAL,DAL,1,37,51,-14,-10,0,-4,-6,23,36,-13,-7,0,-6,-10
Colorado Avalanche,2015/02/14  vs. DAL,DAL,1,54,45,9,3,6,0,5,39,26,13,5,8,0,6
Colorado Avalanche,2015/02/27  vs. DAL,DAL,1,42,55,-13,-1,0,-12,-17,31,41,-10,0,0,-10,-13
Colorado Avalanche,2014/12/21  vs. DET,DET,1,27,49,-22,-18,0,-4,-18,23,37,-14,-13,0,-1,-13
Colorado Avalanche,2015/02/05  vs. DET,DET,1,39,41,-2,6,0,-8,4,29,29,0,7,0,-7,5
Colorado Avalanche,2015/01/02  vs. EDM,EDM,1,41,34,7,1,6,0,8,31,23,8,5,3,0,10
Colorado Avalanche,2015/03/25  vs. EDM,EDM,1,62,52,10,0,0,10,2,47,39,8,0,0,8,3
Colorado Avalanche,2015/03/30  vs. EDM,EDM,1,49,54,-5,-7,0,2,-5,42,46,-4,-5,0,1,-3
Colorado Avalanche,2014/10/21  vs. FLA,FLA,1,34,51,-17,-11,-1,-5,-13,30,41,-11,-8,0,-3,-7
Colorado Avalanche,2015/01/15  vs. FLA,FLA,1,35,51,-16,-14,-2,0,-13,29,36,-7,-6,-1,0,-5
Colorado Avalanche,2015/02/18  vs. LAK,LAK,1,48,43,5,1,0,4,2,39,30,9,1,2,6,4
Colorado Avalanche,2015/03/10  vs. LAK,LAK,1,34,43,-9,-1,0,-8,-5,24,26,-2,-2,0,0,-2
Colorado Avalanche,2015/04/04  vs. LAK,LAK,1,22,64,-42,-6,0,-36,-23,13,51,-38,-8,0,-30,-23
Colorado Avalanche,2014/10/09  vs. MIN,MIN,1,23,64,-41,-14,0,-27,-19,18,57,-39,-14,0,-25,-19
Colorado Avalanche,2014/10/11  vs. MIN,MIN,1,35,26,9,-1,0,10,2,26,19,7,-1,0,8,5
Colorado Avalanche,2015/02/07  vs. MIN,MIN,1,31,53,-22,-15,0,-7,-23,19,39,-20,-12,0,-8,-21
Colorado Avalanche,2015/02/28  vs. MIN,MIN,1,41,48,-7,-5,0,-2,-6,28,34,-6,-2,0,-4,-5
Colorado Avalanche,2015/03/08  vs. MIN,MIN,1,23,52,-29,-15,-14,0,-19,18,37,-19,-10,-9,0,-13
Colorado Avalanche,2014/10/18  vs. MTL,MTL,1,41,56,-15,-2,-11,-2,-13,32,38,-6,1,-9,2,-6
Colorado Avalanche,2014/12/01  vs. MTL,MTL,1,45,51,-6,-3,1,-4,-6,34,38,-4,-3,0,-1,-6
Colorado Avalanche,2014/11/15  vs. NJD,NJD,1,32,36,-4,2,2,-8,-2,29,29,0,4,2,-6,2
Colorado Avalanche,2015/03/12  vs. NJD,NJD,1,46,51,-5,-9,4,0,-5,32,30,2,0,2,0,2
Colorado Avalanche,2014/12/09  vs. NSH,NSH,1,52,36,16,-1,0,17,10,33,28,5,-1,0,6,5
Colorado Avalanche,2015/01/27  vs. NSH,NSH,1,33,71,-38,1,-11,-28,-17,27,52,-25,3,-6,-22,-10
Colorado Avalanche,2015/01/30  vs. NSH,NSH,1,35,52,-17,3,-20,0,-5,28,32,-4,5,-9,0,0
Colorado Avalanche,2015/02/24  vs. NSH,NSH,1,33,58,-25,-6,1,-20,-10,22,47,-25,-8,1,-18,-11
Colorado Avalanche,2015/04/07  vs. NSH,NSH,1,31,68,-37,-9,-14,-14,-25,22,45,-23,-3,-9,-11,-15
Colorado Avalanche,2014/10/30  vs. NYI,NYI,1,27,60,-33,-2,-31,0,-18,24,41,-17,-1,-16,0,-8
Colorado Avalanche,2014/11/11  vs. NYI,NYI,1,34,46,-12,-2,0,-10,0,20,38,-18,-2,0,-16,0
Colorado Avalanche,2014/11/13  vs. NYR,NYR,1,39,44,-5,-6,4,-3,-5,28,34,-6,-8,4,-2,-6
Colorado Avalanche,2015/02/12  vs. NYR,NYR,1,43,43,0,-13,0,13,-18,34,27,7,-6,0,13,-9
Colorado Avalanche,2014/10/16  vs. OTT,OTT,1,35,36,-1,-2,0,1,1,26,24,2,0,2,0,5
Colorado Avalanche,2015/01/08  vs. OTT,OTT,1,24,57,-33,-5,-28,0,-9,22,38,-16,-4,-12,0,-6
Colorado Avalanche,2014/11/08  vs. PHI,PHI,1,47,34,13,-1,0,14,-1,36,23,13,2,0,11,2
Colorado Avalanche,2014/12/31  vs. PHI,PHI,1,39,34,5,6,-3,2,10,28,24,4,9,-3,-2,7
Colorado Avalanche,2014/12/18  vs. PIT,PIT,1,43,58,-15,-15,0,0,-15,35,46,-11,-11,0,0,-11
Colorado Avalanche,2015/03/04  vs. PIT,PIT,1,30,61,-31,1,-32,0,-6,19,39,-20,2,-22,0,-6
Colorado Avalanche,2014/10/28  vs. SJS,SJS,1,35,63,-28,-6,1,-23,-29,30,50,-20,0,1,-21,-21
Colorado Avalanche,2015/04/01  vs. SJS,SJS,1,30,61,-31,-13,0,-18,-17,20,33,-13,-4,0,-9,-6
Colorado Avalanche,2014/11/01  vs. STL,STL,1,31,39,-8,-1,0,-7,-6,21,28,-7,-2,0,-5,-5
Colorado Avalanche,2014/12/13  vs. STL,STL,1,34,49,-15,-9,0,-6,-15,22,38,-16,-11,0,-5,-16
Colorado Avalanche,2014/12/23  vs. STL,STL,1,42,38,4,7,-3,0,5,34,26,8,4,4,0,2
Colorado Avalanche,2014/12/29  vs. STL,STL,1,31,53,-22,-3,0,-19,-12,21,44,-23,-3,0,-20,-11
Colorado Avalanche,2015/01/19  vs. STL,STL,1,27,48,-21,-6,0,-15,-17,19,42,-23,-4,0,-19,-14
Colorado Avalanche,2015/01/17  vs. TBL,TBL,1,47,42,5,8,0,-3,5,39,32,7,9,0,-2,8
Colorado Avalanche,2015/02/22  vs. TBL,TBL,1,37,49,-12,-5,-7,0,-6,24,35,-11,-3,-6,-2,-8
Colorado Avalanche,2014/10/14  vs. TOR,TOR,1,39,47,-8,-6,-3,1,-5,28,36,-8,-7,-1,0,-7
Colorado Avalanche,2014/11/06  vs. TOR,TOR,1,58,61,-3,-10,6,1,-1,40,39,1,-8,9,0,2
Colorado Avalanche,2014/10/24  vs. VAN,VAN,1,52,36,16,1,7,8,11,45,30,15,1,4,10,13
Colorado Avalanche,2014/11/04  vs. VAN,VAN,1,31,56,-25,0,-23,-2,-7,21,38,-17,0,-15,-2,-3
Colorado Avalanche,2015/03/26  vs. VAN,VAN,1,40,48,-8,8,-16,0,15,30,30,0,8,-8,0,13
Colorado Avalanche,2014/10/26  vs. WPG,WPG,1,33,60,-27,-25,0,-2,-27,19,34,-15,-15,0,0,-15
Colorado Avalanche,2014/12/05  vs. WPG,WPG,1,31,48,-17,-8,0,-9,-16,24,37,-13,-5,0,-8,-10
Colorado Avalanche,2014/12/11  vs. WPG,WPG,1,34,46,-12,-10,0,-2,-17,24,32,-8,-9,0,1,-13
Colorado Avalanche,2015/02/08  vs. WPG,WPG,1,35,45,-10,0,-5,-5,-9,26,31,-5,3,-8,0,-4
Colorado Avalanche,2015/04/09  vs. WPG,WPG,1,24,41,-17,-17,0,0,-17,18,33,-15,-15,0,0,-15
Colorado Avalanche,2014/11/20  vs. WSH,WSH,1,46,46,0,-12,0,12,-10,35,30,5,-3,0,8,-3
Colorado Avalanche,2015/01/12  vs. WSH,WSH,1,40,62,-22,-10,0,-12,-24,28,48,-20,-9,0,-11,-23
Columbus Blue Jackets,2014/10/24  vs. ANA,ANA,1,28,41,-13,-1,0,-12,-6,24,32,-8,0,0,-8,-3
Columbus Blue Jackets,2015/03/24  vs. ANA,ANA,1,25,50,-25,-1,-11,-13,-14,22,43,-21,-1,-10,-10,-10
Columbus Blue Jackets,2015/01/03  vs. ARI,ARI,1,36,48,-12,-12,-1,1,-14,24,37,-13,-9,-1,-3,-11
Columbus Blue Jackets,2015/02/03  vs. ARI,ARI,1,50,43,7,-13,0,20,-8,37,28,9,-7,0,16,-2
Columbus Blue Jackets,2014/11/21  vs. BOS,BOS,1,48,60,-12,-6,-6,0,-5,39,43,-4,-1,-2,-1,1
Columbus Blue Jackets,2014/12/27  vs. BOS,BOS,1,34,46,-12,-1,-11,0,3,30,33,-3,1,-4,0,3
Columbus Blue Jackets,2015/01/17  vs. BOS,BOS,1,42,56,-14,-10,-4,0,-14,30,42,-12,-10,-2,0,-12
Columbus Blue Jackets,2014/10/09  vs. BUF,BUF,1,54,33,21,22,-1,0,24,40,28,12,11,1,0,13
Columbus Blue Jackets,2015/02/24  vs. BUF,BUF,1,56,30,26,5,0,21,7,43,26,17,4,0,13,6
Columbus Blue Jackets,2015/04/10  vs. BUF,BUF,1,57,32,25,3,22,0,21,46,28,18,1,17,0,14
Columbus Blue Jackets,2014/11/04  vs. CAR,CAR,1,30,31,-1,-2,0,1,-7,22,26,-4,-1,0,-3,-4
Columbus Blue Jackets,2014/11/07  vs. CAR,CAR,1,36,52,-16,-5,-8,-3,-10,26,35,-9,-2,-5,-2,-6
Columbus Blue Jackets,2015/03/10  vs. CAR,CAR,1,43,47,-4,1,0,-5,-8,33,35,-2,-1,0,-1,-9
Columbus Blue Jackets,2015/03/15  vs. CAR,CAR,1,37,30,7,-2,-2,11,-7,27,26,1,-2,-2,5,-7
Columbus Blue Jackets,2014/10/17  vs. CGY,CGY,1,38,34,4,3,1,0,3,28,24,4,2,2,0,3
Columbus Blue Jackets,2015/03/21  vs. CGY,CGY,1,44,53,-9,-13,0,4,-14,30,41,-11,-11,0,0,-14
Columbus Blue Jackets,2014/12/20  vs. CHI,CHI,1,31,49,-18,-11,-7,0,-15,20,43,-23,-17,-6,0,-22
Columbus Blue Jackets,2015/03/27  vs. CHI,CHI,1,32,38,-6,4,-10,0,6,25,29,-4,3,-7,0,4
Columbus Blue Jackets,2015/01/04  vs. COL,COL,1,47,38,9,11,-6,4,8,35,30,5,7,-5,3,4
Columbus Blue Jackets,2015/03/07  vs. COL,COL,1,58,25,33,1,0,32,1,46,21,25,1,0,24,1
Columbus Blue Jackets,2014/10/14  vs. DAL,DAL,1,44,58,-14,-8,0,-6,-9,35,45,-10,-3,0,-7,-4
Columbus Blue Jackets,2015/01/06  vs. DAL,DAL,1,27,37,-10,3,-13,0,9,23,26,-3,4,-7,0,8
Columbus Blue Jackets,2014/11/18  vs. DET,DET,1,47,42,5,-2,0,7,3,31,33,-2,0,0,-2,4
Columbus Blue Jackets,2014/12/16  vs. DET,DET,1,36,41,-5,-5,0,0,-5,30,33,-3,-3,0,0,-3
Columbus Blue Jackets,2015/03/12  vs. DET,DET,1,33,44,-11,5,-22,6,2,25,35,-10,3,-16,3,-2
Columbus Blue Jackets,2015/03/13  vs. EDM,EDM,1,41,39,2,-5,0,7,-5,30,31,-1,-5,-1,5,-6
Columbus Blue Jackets,2015/03/18  vs. EDM,EDM,1,28,49,-21,-12,-8,-1,-25,20,43,-23,-14,-8,-1,-25
Columbus Blue Jackets,2014/12/01  vs. FLA,FLA,1,38,49,-11,-11,0,0,-7,33,30,3,0,3,0,5
Columbus Blue Jackets,2014/12/04  vs. FLA,FLA,1,26,71,-45,-22,-23,0,-27,21,50,-29,-18,-11,0,-21
Columbus Blue Jackets,2015/01/29  vs. FLA,FLA,1,42,40,2,7,0,-5,4,36,34,2,7,0,-5,4
Columbus Blue Jackets,2014/10/26  vs. LAK,LAK,1,38,50,-12,-4,-2,-6,-7,30,39,-9,-3,-2,-4,-4
Columbus Blue Jackets,2015/02/09  vs. LAK,LAK,1,36,62,-26,-1,1,-26,-14,27,53,-26,-3,1,-24,-14
Columbus Blue Jackets,2014/12/31  vs. MIN,MIN,1,33,39,-6,0,-6,0,0,28,32,-4,0,-2,-2,-2
Columbus Blue Jackets,2015/01/19  vs. MIN,MIN,1,37,45,-8,-6,-2,0,-6,25,34,-9,-8,-1,0,-8
Columbus Blue Jackets,2015/01/14  vs. MTL,MTL,1,31,42,-11,-1,-10,0,-11,25,30,-5,-1,-5,1,-6
Columbus Blue Jackets,2015/02/21  vs. MTL,MTL,1,53,42,11,4,0,7,6,33,24,9,1,0,8,8
Columbus Blue Jackets,2015/02/26  vs. MTL,MTL,1,40,39,1,-1,0,2,-5,30,31,-1,-1,0,0,-6
Columbus Blue Jackets,2014/11/01  vs. NJD,NJD,1,24,34,-10,4,-13,-1,-6,22,24,-2,3,-4,-1,2
Columbus Blue Jackets,2015/02/28  vs. NJD,NJD,1,42,36,6,6,0,0,-3,32,22,10,4,0,6,1
Columbus Blue Jackets,2015/03/06  vs. NJD,NJD,1,37,43,-6,3,-9,0,4,28,32,-4,2,-6,0,3
Columbus Blue Jackets,2015/03/31  vs. NJD,NJD,1,39,25,14,8,5,1,14,30,24,6,2,3,1,7
Columbus Blue Jackets,2014/11/29  vs. NSH,NSH,1,29,60,-31,-26,0,-5,-31,21,43,-22,-18,0,-4,-21
Columbus Blue Jackets,2014/12/22  vs. NSH,NSH,1,46,48,-2,2,0,-4,-2,35,37,-2,1,0,-3,-2
Columbus Blue Jackets,2015/01/10  vs. NYI,NYI,1,33,46,-13,-9,0,-4,-14,22,40,-18,-12,0,-6,-18
Columbus Blue Jackets,2015/02/14  vs. NYI,NYI,1,49,58,-9,-1,0,-8,-13,34,43,-9,-3,0,-6,-13
Columbus Blue Jackets,2015/04/02  vs. NYI,NYI,1,49,40,9,2,0,7,2,36,32,4,-1,0,5,-1
Columbus Blue Jackets,2015/04/11  vs. NYI,NYI,1,49,68,-19,-15,0,-4,-15,37,54,-17,-12,0,-5,-12
Columbus Blue Jackets,2014/10/11  vs. NYR,NYR,1,36,34,2,3,-1,0,-5,29,26,3,2,1,0,-4
Columbus Blue Jackets,2015/01/16  vs. NYR,NYR,1,49,30,19,12,0,7,9,35,20,15,9,0,6,7
Columbus Blue Jackets,2015/02/22  vs. NYR,NYR,1,41,41,0,4,0,-4,7,31,32,-1,1,0,-2,4
Columbus Blue Jackets,2015/04/06  vs. NYR,NYR,1,50,39,11,4,-2,9,13,39,28,11,3,-3,11,14
Columbus Blue Jackets,2014/10/18  vs. OTT,OTT,1,52,46,6,-2,0,8,1,45,35,10,1,0,9,5
Columbus Blue Jackets,2014/10/28  vs. OTT,OTT,1,43,43,0,3,-1,-2,2,35,34,1,8,-1,-6,4
Columbus Blue Jackets,2015/02/07  vs. OTT,OTT,1,48,52,-4,12,-16,0,12,37,40,-3,6,-9,0,6
Columbus Blue Jackets,2014/11/14  vs. PHI,PHI,1,53,42,11,2,9,0,1,42,29,13,1,12,0,2
Columbus Blue Jackets,2014/11/22  vs. PHI,PHI,1,33,46,-13,-5,0,-8,-12,24,36,-12,-3,0,-9,-9
Columbus Blue Jackets,2014/12/09  vs. PHI,PHI,1,32,30,2,6,-4,0,12,19,22,-3,2,-5,0,4
Columbus Blue Jackets,2015/02/13  vs. PHI,PHI,1,56,39,17,-1,0,18,12,38,27,11,1,0,10,9
Columbus Blue Jackets,2015/02/17  vs. PHI,PHI,1,33,66,-33,-9,-24,0,-14,29,48,-19,-5,-14,0,-9
Columbus Blue Jackets,2014/12/13  vs. PIT,PIT,1,29,35,-6,-7,2,-1,-5,19,24,-5,-3,-2,0,-5
Columbus Blue Jackets,2015/02/19  vs. PIT,PIT,1,34,44,-10,-11,1,0,-9,25,33,-8,-9,1,0,-8
Columbus Blue Jackets,2015/03/01  vs. PIT,PIT,1,29,46,-17,-7,-1,-9,-8,20,32,-12,-8,0,-4,-8
Columbus Blue Jackets,2015/04/04  vs. PIT,PIT,1,45,37,8,10,0,-2,8,36,32,4,8,0,-4,5
Columbus Blue Jackets,2014/10/23  vs. SJS,SJS,1,35,39,-4,-1,0,-3,-6,24,33,-9,-4,1,-6,-10
Columbus Blue Jackets,2014/11/15  vs. SJS,SJS,1,26,59,-33,-7,-26,0,-27,22,44,-22,-3,-19,0,-20
Columbus Blue Jackets,2015/02/06  vs. STL,STL,1,43,55,-12,-3,-9,0,-3,37,44,-7,-1,-6,0,-1
Columbus Blue Jackets,2015/03/28  vs. STL,STL,1,21,40,-19,-6,-13,0,-3,17,27,-10,-2,-8,0,1
Columbus Blue Jackets,2014/11/08  vs. TBL,TBL,1,46,54,-8,-8,0,0,-10,30,45,-15,-7,0,-8,-9
Columbus Blue Jackets,2014/12/06  vs. TBL,TBL,1,28,44,-16,0,-16,0,-2,22,34,-12,-1,-11,0,-4
Columbus Blue Jackets,2015/01/31  vs. TBL,TBL,1,29,51,-22,-6,0,-16,-8,25,36,-11,1,0,-12,-1
Columbus Blue Jackets,2014/10/31  vs. TOR,TOR,1,41,39,2,-6,0,8,-5,29,30,-1,-5,0,4,-4
Columbus Blue Jackets,2015/01/09  vs. TOR,TOR,1,46,41,5,-7,1,11,-8,34,30,4,-7,2,9,-6
Columbus Blue Jackets,2015/04/08  vs. TOR,TOR,1,42,42,0,4,-4,0,7,36,34,2,2,0,0,5
Columbus Blue Jackets,2014/11/28  vs. VAN,VAN,1,45,41,4,-2,0,6,-1,37,34,3,0,0,3,-2
Columbus Blue Jackets,2015/03/19  vs. VAN,VAN,1,49,65,-16,-4,-11,-1,-1,35,51,-16,-7,-6,-3,-6
Columbus Blue Jackets,2014/11/25  vs. WPG,WPG,1,38,34,4,-5,0,9,-7,31,24,7,1,0,6,-1
Columbus Blue Jackets,2015/01/21  vs. WPG,WPG,1,43,45,-2,1,0,-3,0,29,38,-9,1,0,-10,4
Columbus Blue Jackets,2014/11/11  vs. WSH,WSH,1,46,36,10,1,0,9,2,29,27,2,2,0,0,2
Columbus Blue Jackets,2014/12/11  vs. WSH,WSH,1,35,41,-6,-5,0,-1,-7,27,29,-2,2,0,-4,-2
Columbus Blue Jackets,2014/12/18  vs. WSH,WSH,1,30,44,-14,-9,-6,1,-5,27,34,-7,-6,-4,3,-3
Columbus Blue Jackets,2015/01/27  vs. WSH,WSH,1,32,38,-6,-9,3,0,-10,27,32,-5,-8,3,0,-10
Columbus Blue Jackets,2015/03/03  vs. WSH,WSH,1,40,35,5,-3,0,8,-3,27,31,-4,-3,0,-1,-5
Dallas Stars,2014/10/31  vs. ANA,ANA,1,37,27,10,6,0,4,9,26,19,7,7,0,0,9
Dallas Stars,2015/03/01  vs. ANA,ANA,1,68,39,29,7,0,22,26,45,30,15,1,0,14,11
Dallas Stars,2015/04/08  vs. ANA,ANA,1,56,36,20,12,8,0,16,46,28,18,7,11,0,11
Dallas Stars,2014/11/11  vs. ARI,ARI,1,40,50,-10,-6,1,-5,-15,28,35,-7,-2,1,-6,-11
Dallas Stars,2014/11/20  vs. ARI,ARI,1,50,37,13,0,5,8,8,44,26,18,2,7,9,11
Dallas Stars,2014/12/31  vs. ARI,ARI,1,54,45,9,8,1,0,9,45,31,14,6,8,0,7
Dallas Stars,2015/01/20  vs. BOS,BOS,1,51,39,12,-2,1,13,-2,39,31,8,-1,2,7,1
Dallas Stars,2015/02/10  vs. BOS,BOS,1,41,49,-8,-12,4,0,-4,35,37,-2,-9,7,0,-1
Dallas Stars,2015/02/07  vs. BUF,BUF,1,71,31,40,6,0,34,6,49,24,25,7,0,18,7
Dallas Stars,2015/03/23  vs. BUF,BUF,1,84,39,45,29,0,16,45,47,31,16,11,1,4,17
Dallas Stars,2014/11/18  vs. CAR,CAR,1,39,44,-5,-2,-19,16,-16,32,33,-1,-2,-12,13,-9
Dallas Stars,2015/03/12  vs. CAR,CAR,1,51,45,6,0,4,2,-1,39,27,12,1,8,3,2
Dallas Stars,2014/10/14  vs. CBJ,CBJ,1,58,44,14,8,6,0,9,45,35,10,3,7,0,4
Dallas Stars,2015/01/06  vs. CBJ,CBJ,1,37,27,10,-3,0,13,-9,26,23,3,-4,0,7,-8
Dallas Stars,2014/12/19  vs. CGY,CGY,1,52,26,26,10,16,0,12,32,20,12,0,12,0,2
Dallas Stars,2015/03/25  vs. CGY,CGY,1,35,34,1,9,-8,0,3,21,25,-4,1,-5,0,-2
Dallas Stars,2015/03/30  vs. CGY,CGY,1,79,34,45,-3,19,29,13,54,28,26,-2,6,22,1
Dallas Stars,2014/10/09  vs. CHI,CHI,1,48,42,6,7,-5,4,14,36,26,10,11,-1,0,15
Dallas Stars,2014/11/16  vs. CHI,CHI,1,39,61,-22,-2,-3,-17,-7,29,47,-18,-2,-4,-12,-8
Dallas Stars,2015/01/04  vs. CHI,CHI,1,45,56,-11,-10,-1,0,-8,34,37,-3,-9,6,0,-3
Dallas Stars,2015/01/18  vs. CHI,CHI,1,44,67,-23,-27,4,0,-24,36,49,-13,-18,5,0,-18
Dallas Stars,2015/03/21  vs. CHI,CHI,1,36,55,-19,0,-19,0,-3,30,38,-8,0,-8,0,-1
Dallas Stars,2014/11/29  vs. COL,COL,1,47,45,2,-2,0,4,-7,35,37,-2,-6,0,4,-10
Dallas Stars,2015/01/10  vs. COL,COL,1,57,35,22,5,9,8,3,38,33,5,2,-1,4,-2
Dallas Stars,2015/02/03  vs. COL,COL,1,51,37,14,10,4,0,6,36,23,13,7,6,0,10
Dallas Stars,2015/02/14  vs. COL,COL,1,45,54,-9,-3,0,-6,-5,26,39,-13,-5,0,-8,-6
Dallas Stars,2015/02/27  vs. COL,COL,1,55,42,13,1,12,0,17,41,31,10,0,10,0,13
Dallas Stars,2014/12/04  vs. DET,DET,1,25,42,-17,-3,0,-14,-7,22,31,-9,-2,0,-7,-3
Dallas Stars,2015/02/21  vs. DET,DET,1,56,55,1,3,1,-3,8,39,44,-5,1,-1,-5,1
Dallas Stars,2014/11/25  vs. EDM,EDM,1,53,61,-8,-7,-1,0,1,40,40,0,-2,2,0,4
Dallas Stars,2014/12/21  vs. EDM,EDM,1,63,39,24,3,0,21,2,47,29,18,3,0,15,1
Dallas Stars,2015/03/27  vs. EDM,EDM,1,67,41,26,0,0,26,25,44,33,11,0,0,11,16
Dallas Stars,2015/02/13  vs. FLA,FLA,1,45,43,2,-2,4,0,3,37,34,3,-2,5,0,2
Dallas Stars,2015/03/05  vs. FLA,FLA,1,52,26,26,5,15,6,13,36,22,14,3,9,2,6
Dallas Stars,2014/11/04  vs. LAK,LAK,1,45,41,4,1,2,1,3,34,31,3,0,1,2,1
Dallas Stars,2014/11/13  vs. LAK,LAK,1,38,42,-4,6,-10,0,3,29,34,-5,4,-9,0,3
Dallas Stars,2014/11/22  vs. LAK,LAK,1,30,55,-25,0,-25,0,3,24,43,-19,-2,-17,0,1
Dallas Stars,2014/11/01  vs. MIN,MIN,1,43,40,3,-2,0,5,-2,24,32,-8,-5,0,-3,-13
Dallas Stars,2014/11/15  vs. MIN,MIN,1,60,48,12,1,7,4,8,38,33,5,0,4,1,4
Dallas Stars,2014/11/28  vs. MIN,MIN,1,67,50,17,2,-2,17,10,50,37,13,1,-1,13,10
Dallas Stars,2015/01/03  vs. MIN,MIN,1,56,30,26,6,20,0,21,42,20,22,4,18,0,14
Dallas Stars,2015/02/22  vs. MIN,MIN,1,29,41,-12,-10,-4,2,-13,20,33,-13,-8,-3,-2,-10
Dallas Stars,2014/12/06  vs. MTL,MTL,1,45,33,12,15,-3,0,15,33,19,14,8,6,0,9
Dallas Stars,2015/01/27  vs. MTL,MTL,1,56,29,27,-1,0,28,9,41,20,21,1,0,20,10
Dallas Stars,2014/10/24  vs. NJD,NJD,1,44,39,5,4,-1,2,7,39,32,7,6,-1,2,8
Dallas Stars,2014/12/13  vs. NJD,NJD,1,67,58,9,3,6,0,3,49,46,3,0,3,0,0
Dallas Stars,2014/10/11  vs. NSH,NSH,1,37,45,-8,0,-5,-3,-5,27,31,-4,0,-1,-3,-1
Dallas Stars,2014/11/06  vs. NSH,NSH,1,61,64,-3,-15,0,12,-16,49,45,4,-5,0,9,-3
Dallas Stars,2015/01/08  vs. NSH,NSH,1,35,51,-16,-12,0,-4,-16,23,33,-10,-5,0,-5,-10
Dallas Stars,2015/04/04  vs. NSH,NSH,1,40,61,-21,-14,-8,1,-13,26,46,-20,-13,-4,-3,-16
Dallas Stars,2015/04/11  vs. NSH,NSH,1,53,51,2,0,2,0,4,36,30,6,-1,7,0,6
Dallas Stars,2014/10/25  vs. NYI,NYI,1,47,41,6,8,2,-4,5,34,33,1,5,2,-6,1
Dallas Stars,2015/03/03  vs. NYI,NYI,1,65,53,12,12,-1,1,10,45,37,8,8,0,0,6
Dallas Stars,2014/12/29  vs. NYR,NYR,1,35,44,-9,2,-14,3,-1,25,29,-4,1,-6,1,0
Dallas Stars,2015/02/08  vs. NYR,NYR,1,37,57,-20,-3,-17,0,-3,27,42,-15,-2,-13,0,-1
Dallas Stars,2015/01/13  vs. OTT,OTT,1,44,58,-14,-4,-13,3,-6,33,40,-7,-2,-9,4,-2
Dallas Stars,2015/01/29  vs. OTT,OTT,1,46,43,3,7,-4,0,9,39,29,10,7,3,0,14
Dallas Stars,2014/10/18  vs. PHI,PHI,1,42,66,-24,-13,-6,-5,-20,34,44,-10,-5,-4,-1,-7
Dallas Stars,2015/03/10  vs. PHI,PHI,1,53,38,15,12,2,1,13,41,27,14,14,2,-2,12
Dallas Stars,2014/10/16  vs. PIT,PIT,1,47,48,-1,1,0,-2,1,33,32,1,0,0,1,-3
Dallas Stars,2015/03/19  vs. PIT,PIT,1,42,46,-4,11,-15,0,5,30,31,-1,10,-11,0,6
Dallas Stars,2014/11/08  vs. SJS,SJS,1,60,57,3,-2,-4,9,-6,44,35,9,-4,5,8,-1
Dallas Stars,2015/02/19  vs. SJS,SJS,1,68,48,20,-2,0,22,1,48,35,13,-2,0,15,0
Dallas Stars,2015/04/06  vs. SJS,SJS,1,40,40,0,2,-2,0,4,22,28,-6,1,-7,0,-1
Dallas Stars,2014/10/28  vs. STL,STL,1,43,34,9,6,3,0,8,32,24,8,7,1,0,9
Dallas Stars,2014/12/27  vs. STL,STL,1,38,56,-18,-6,-12,0,-13,27,42,-15,-1,-14,0,-7
Dallas Stars,2015/02/17  vs. STL,STL,1,29,42,-13,2,-15,0,4,23,26,-3,1,-4,0,1
Dallas Stars,2015/03/15  vs. STL,STL,1,45,29,16,10,0,6,10,31,22,9,7,0,2,7
Dallas Stars,2015/04/03  vs. STL,STL,1,44,27,17,5,6,6,10,32,18,14,10,2,2,12
Dallas Stars,2015/02/05  vs. TBL,TBL,1,55,53,2,-3,0,5,-5,49,32,17,4,0,13,4
Dallas Stars,2015/03/07  vs. TBL,TBL,1,44,45,-1,0,-6,5,-11,36,33,3,0,-4,7,-7
Dallas Stars,2014/12/02  vs. TOR,TOR,1,45,47,-2,0,0,-2,10,35,39,-4,0,0,-4,7
Dallas Stars,2014/12/23  vs. TOR,TOR,1,62,28,34,-1,0,35,7,51,23,28,0,0,28,8
Dallas Stars,2014/10/21  vs. VAN,VAN,1,32,51,-19,-2,-17,0,-2,26,45,-19,-3,-16,0,-4
Dallas Stars,2014/12/17  vs. VAN,VAN,1,43,32,11,-3,14,0,12,33,26,7,-3,10,0,10
Dallas Stars,2015/03/28  vs. VAN,VAN,1,55,47,8,7,-5,6,0,46,38,8,7,-2,3,4
Dallas Stars,2014/12/09  vs. WPG,WPG,1,47,50,-3,-6,0,3,-8,32,38,-6,-4,0,-2,-6
Dallas Stars,2015/01/15  vs. WPG,WPG,1,55,31,24,1,0,23,19,41,24,17,-1,0,18,14
Dallas Stars,2015/01/31  vs. WPG,WPG,1,30,74,-44,6,-50,0,-29,27,49,-22,5,-27,0,-17
Dallas Stars,2015/02/24  vs. WPG,WPG,1,60,38,22,1,0,21,12,43,33,10,2,0,8,6
Dallas Stars,2015/01/17  vs. WSH,WSH,1,35,55,-20,0,-20,0,-3,25,35,-10,-1,-9,0,-2
Dallas Stars,2015/03/13  vs. WSH,WSH,1,41,33,8,2,6,0,14,30,23,7,3,4,0,9
Detroit Red Wings,2014/10/11  vs. ANA,ANA,1,42,35,7,4,3,0,5,27,25,2,-1,2,1,1
Detroit Red Wings,2015/02/23  vs. ANA,ANA,1,39,38,1,4,-4,1,5,33,28,5,6,-2,1,7
Detroit Red Wings,2015/02/07  vs. ARI,ARI,1,34,27,7,8,-1,0,6,20,16,4,4,0,0,3
Detroit Red Wings,2015/03/24  vs. ARI,ARI,1,47,28,19,20,0,-1,18,37,21,16,15,0,1,15
Detroit Red Wings,2014/10/09  vs. BOS,BOS,1,40,16,24,21,3,0,23,28,12,16,16,0,0,17
Detroit Red Wings,2014/10/15  vs. BOS,BOS,1,28,48,-20,-16,0,-4,-21,20,37,-17,-14,0,-3,-18
Detroit Red Wings,2014/12/29  vs. BOS,BOS,1,37,51,-14,-3,0,-11,-2,27,44,-17,-2,0,-15,-6
Detroit Red Wings,2015/03/08  vs. BOS,BOS,1,45,30,15,-2,0,17,5,35,25,10,-1,0,11,1
Detroit Red Wings,2015/04/02  vs. BOS,BOS,1,45,21,24,17,8,-1,26,39,16,23,17,7,-1,25
Detroit Red Wings,2014/11/02  vs. BUF,BUF,1,50,26,24,14,7,3,17,39,24,15,7,7,1,8
Detroit Red Wings,2014/12/23  vs. BUF,BUF,1,53,20,33,13,1,19,27,37,16,21,11,-2,12,20
Detroit Red Wings,2015/01/13  vs. BUF,BUF,1,48,26,22,2,20,0,12,31,24,7,0,7,0,2
Detroit Red Wings,2015/01/18  vs. BUF,BUF,1,41,26,15,5,4,6,8,25,23,2,3,1,-2,1
Detroit Red Wings,2014/12/07  vs. CAR,CAR,1,26,41,-15,-4,-11,0,-2,20,29,-9,-1,-8,0,1
Detroit Red Wings,2015/04/07  vs. CAR,CAR,1,38,44,-6,0,-5,-1,-1,29,39,-10,-1,-8,-1,-5
Detroit Red Wings,2015/04/11  vs. CAR,CAR,1,53,49,4,2,2,0,9,33,40,-7,0,-7,0,-4
Detroit Red Wings,2014/11/18  vs. CBJ,CBJ,1,42,47,-5,2,-7,0,-3,33,31,2,0,2,0,-4
Detroit Red Wings,2014/12/16  vs. CBJ,CBJ,1,41,36,5,5,0,0,5,33,30,3,3,0,0,3
Detroit Red Wings,2015/03/12  vs. CBJ,CBJ,1,44,33,11,-5,-6,22,-2,35,25,10,-3,-3,16,2
Detroit Red Wings,2015/01/07  vs. CGY,CGY,1,44,34,10,9,1,0,9,31,28,3,9,-3,-3,6
Detroit Red Wings,2015/03/06  vs. CGY,CGY,1,57,28,29,3,16,10,27,37,24,13,2,6,5,16
Detroit Red Wings,2014/11/14  vs. CHI,CHI,1,41,43,-2,6,-8,0,6,34,31,3,5,-2,0,7
Detroit Red Wings,2015/02/18  vs. CHI,CHI,1,45,49,-4,-5,1,0,-4,29,34,-5,-6,1,0,-5
Detroit Red Wings,2014/12/21  vs. COL,COL,1,49,27,22,18,4,0,18,37,23,14,13,1,0,13
Detroit Red Wings,2015/02/05  vs. COL,COL,1,41,39,2,-6,8,0,-4,29,29,0,-7,7,0,-5
Detroit Red Wings,2014/12/04  vs. DAL,DAL,1,42,25,17,3,14,0,7,31,22,9,2,7,0,3
Detroit Red Wings,2015/02/21  vs. DAL,DAL,1,55,56,-1,-3,3,-1,-8,44,39,5,-1,5,1,-1
Detroit Red Wings,2015/01/06  vs. EDM,EDM,1,59,32,27,16,9,2,21,43,27,16,10,7,-1,11
Detroit Red Wings,2015/03/09  vs. EDM,EDM,1,40,36,4,2,4,-2,1,31,32,-1,-1,3,-3,-1
Detroit Red Wings,2014/12/02  vs. FLA,FLA,1,44,43,1,-4,-5,10,-3,32,35,-3,-3,-4,4,-5
Detroit Red Wings,2014/12/12  vs. FLA,FLA,1,35,32,3,1,-1,3,3,27,27,0,0,-1,1,0
Detroit Red Wings,2015/01/27  vs. FLA,FLA,1,49,40,9,3,-3,9,15,38,31,7,1,-3,9,11
Detroit Red Wings,2015/03/19  vs. FLA,FLA,1,46,36,10,6,0,4,4,39,32,7,7,0,0,5
Detroit Red Wings,2014/10/31  vs. LAK,LAK,1,41,30,11,10,1,0,6,31,24,7,6,1,0,2
Detroit Red Wings,2015/02/24  vs. LAK,LAK,1,30,32,-2,-2,0,0,-3,20,27,-7,-3,0,-4,-8
Detroit Red Wings,2015/01/20  vs. MIN,MIN,1,36,33,3,5,-2,0,4,26,26,0,3,-3,0,2
Detroit Red Wings,2015/04/04  vs. MIN,MIN,1,45,33,12,7,4,1,7,29,27,2,0,2,0,0
Detroit Red Wings,2014/10/21  vs. MTL,MTL,1,41,46,-5,9,-14,0,4,27,34,-7,-1,-6,0,-3
Detroit Red Wings,2014/11/16  vs. MTL,MTL,1,32,32,0,-4,0,4,-6,24,26,-2,-4,0,2,-6
Detroit Red Wings,2015/02/16  vs. MTL,MTL,1,47,32,15,16,0,-1,16,31,25,6,7,0,-1,7
Detroit Red Wings,2015/04/09  vs. MTL,MTL,1,33,36,-3,3,-5,-1,-3,26,30,-4,4,-7,-1,-3
Detroit Red Wings,2014/11/07  vs. NJD,NJD,1,29,30,-1,-1,0,0,3,26,17,9,0,8,1,9
Detroit Red Wings,2014/11/28  vs. NJD,NJD,1,31,28,3,2,0,1,4,27,25,2,0,0,2,3
Detroit Red Wings,2014/12/31  vs. NJD,NJD,1,40,21,19,16,4,-1,15,31,14,17,14,4,-1,13
Detroit Red Wings,2015/01/17  vs. NSH,NSH,1,36,43,-7,-1,-6,0,-2,27,35,-8,-1,-7,0,-2
Detroit Red Wings,2015/02/28  vs. NSH,NSH,1,40,38,2,4,3,-5,3,26,33,-7,-3,1,-5,-4
Detroit Red Wings,2014/12/19  vs. NYI,NYI,1,37,36,1,-1,-2,4,-1,26,29,-3,-1,-1,-1,-2
Detroit Red Wings,2015/01/31  vs. NYI,NYI,1,26,36,-10,-6,-4,0,-5,18,27,-9,-5,-4,0,-6
Detroit Red Wings,2015/03/29  vs. NYI,NYI,1,37,40,-3,-4,1,0,-1,25,25,0,-1,1,0,1
Detroit Red Wings,2014/11/05  vs. NYR,NYR,1,43,35,8,-4,0,12,4,31,27,4,-2,0,6,3
Detroit Red Wings,2014/12/06  vs. NYR,NYR,1,47,30,17,12,4,1,15,40,24,16,12,4,0,16
Detroit Red Wings,2015/03/04  vs. NYR,NYR,1,39,52,-13,-15,2,0,-13,28,48,-20,-21,1,0,-20
Detroit Red Wings,2014/11/04  vs. OTT,OTT,1,49,37,12,4,0,8,11,38,27,11,1,0,10,8
Detroit Red Wings,2014/11/24  vs. OTT,OTT,1,39,31,8,-1,-1,10,13,34,20,14,1,4,9,12
Detroit Red Wings,2014/12/27  vs. OTT,OTT,1,34,40,-6,-8,0,2,-9,29,29,0,-3,0,3,-3
Detroit Red Wings,2015/03/31  vs. OTT,OTT,1,27,44,-17,-14,-3,0,-17,22,35,-13,-13,0,0,-15
Detroit Red Wings,2014/10/25  vs. PHI,PHI,1,63,21,42,10,23,9,33,38,14,24,6,13,5,19
Detroit Red Wings,2014/11/26  vs. PHI,PHI,1,30,40,-10,-7,-3,0,-4,23,33,-10,-6,-4,0,-4
Detroit Red Wings,2015/03/14  vs. PHI,PHI,1,48,51,-3,-3,0,0,-4,34,36,-2,0,0,-2,0
Detroit Red Wings,2014/10/23  vs. PIT,PIT,1,31,30,1,1,0,0,7,27,22,5,2,0,3,7
Detroit Red Wings,2015/02/11  vs. PIT,PIT,1,47,34,13,-2,0,15,-3,35,26,9,-1,0,10,-3
Detroit Red Wings,2015/03/15  vs. PIT,PIT,1,31,49,-18,-2,-16,0,0,20,34,-14,-1,-13,0,-4
Detroit Red Wings,2015/02/26  vs. SJS,SJS,1,54,30,24,-9,1,32,14,40,18,22,-5,1,26,14
Detroit Red Wings,2015/03/26  vs. SJS,SJS,1,54,36,18,-4,0,22,7,39,30,9,-3,0,12,4
Detroit Red Wings,2015/01/15  vs. STL,STL,1,41,31,10,11,-1,0,13,25,23,2,2,0,0,4
Detroit Red Wings,2015/03/22  vs. STL,STL,1,26,29,-3,-5,0,2,-3,18,22,-4,-4,0,0,-4
Detroit Red Wings,2014/11/09  vs. TBL,TBL,1,28,36,-8,-9,-2,3,-12,16,30,-14,-9,-3,-2,-15
Detroit Red Wings,2015/01/29  vs. TBL,TBL,1,44,49,-5,-5,0,0,-5,36,40,-4,-5,0,1,-4
Detroit Red Wings,2015/03/20  vs. TBL,TBL,1,32,41,-9,-11,0,2,-13,28,32,-4,-6,0,2,-7
Detroit Red Wings,2015/03/28  vs. TBL,TBL,1,37,27,10,7,3,0,10,30,24,6,6,0,0,9
Detroit Red Wings,2014/10/17  vs. TOR,TOR,1,49,38,11,-3,14,0,-2,36,30,6,-5,11,0,-5
Detroit Red Wings,2014/10/18  vs. TOR,TOR,1,29,42,-13,-13,0,0,-13,28,36,-8,-8,0,0,-8
Detroit Red Wings,2014/11/22  vs. TOR,TOR,1,46,35,11,12,0,-1,13,32,28,4,7,0,-3,7
Detroit Red Wings,2014/12/10  vs. TOR,TOR,1,58,18,40,38,2,0,38,49,15,34,32,2,0,32
Detroit Red Wings,2014/12/13  vs. TOR,TOR,1,48,50,-2,-16,1,13,-14,35,41,-6,-15,1,8,-13
Detroit Red Wings,2014/11/30  vs. VAN,VAN,1,42,38,4,1,3,0,4,28,31,-3,1,-4,0,1
Detroit Red Wings,2015/01/03  vs. VAN,VAN,1,35,32,3,-2,0,5,2,24,23,1,-3,0,4,2
Detroit Red Wings,2014/11/20  vs. WPG,WPG,1,36,50,-14,-8,-2,-4,-14,25,37,-12,-4,-2,-6,-10
Detroit Red Wings,2015/02/14  vs. WPG,WPG,1,31,36,-5,-5,-2,2,-6,26,33,-7,-7,-1,1,-7
Detroit Red Wings,2014/10/29  vs. WSH,WSH,1,27,36,-9,-9,-1,1,-9,18,25,-7,-6,0,-1,-6
Detroit Red Wings,2015/01/10  vs. WSH,WSH,1,52,26,26,-3,0,29,11,34,18,16,-1,0,17,11
Detroit Red Wings,2015/04/05  vs. WSH,WSH,1,36,35,1,-2,0,3,0,25,29,-4,-2,0,-2,-3
Edmonton Oilers,2014/12/10  vs. ANA,ANA,1,37,37,0,-4,0,4,0,28,31,-3,-4,0,1,-2
Edmonton Oilers,2014/12/12  vs. ANA,ANA,1,38,29,9,-2,0,11,-6,26,23,3,-2,0,5,-5
Edmonton Oilers,2015/02/21  vs. ANA,ANA,1,48,39,9,0,0,9,8,31,26,5,0,0,5,4
Edmonton Oilers,2015/04/01  vs. ANA,ANA,1,44,44,0,7,0,-7,5,32,38,-6,4,0,-10,2
Edmonton Oilers,2014/10/15  vs. ARI,ARI,1,40,35,5,0,0,5,0,26,29,-3,-2,0,-1,-3
Edmonton Oilers,2014/11/16  vs. ARI,ARI,1,44,45,-1,7,0,-8,6,30,29,1,6,0,-5,6
Edmonton Oilers,2014/12/01  vs. ARI,ARI,1,36,32,4,-3,0,7,-1,28,22,6,1,0,5,3
Edmonton Oilers,2014/12/16  vs. ARI,ARI,1,51,61,-10,-2,-8,0,-10,38,44,-6,0,-6,0,-6
Edmonton Oilers,2014/12/23  vs. ARI,ARI,1,38,47,-9,-3,0,-6,-3,26,29,-3,-3,0,0,2
Edmonton Oilers,2014/11/06  vs. BOS,BOS,1,42,37,5,6,3,-4,9,33,27,6,7,3,-4,9
Edmonton Oilers,2015/02/18  vs. BOS,BOS,1,41,56,-15,-7,-8,0,-12,26,43,-17,-10,-7,0,-14
Edmonton Oilers,2014/11/07  vs. BUF,BUF,1,77,44,33,14,9,10,16,60,37,23,10,6,7,10
Edmonton Oilers,2015/01/29  vs. BUF,BUF,1,63,34,29,5,17,7,13,46,25,21,3,13,5,10
Edmonton Oilers,2014/10/24  vs. CAR,CAR,1,47,50,-3,1,-4,0,2,32,38,-6,-4,-2,0,-4
Edmonton Oilers,2015/03/08  vs. CAR,CAR,1,26,55,-29,-13,-17,1,-25,16,39,-23,-8,-13,-2,-16
Edmonton Oilers,2015/03/13  vs. CBJ,CBJ,1,39,41,-2,5,-7,0,5,31,30,1,5,-5,1,6
Edmonton Oilers,2015/03/18  vs. CBJ,CBJ,1,49,28,21,12,1,8,25,43,20,23,14,1,8,25
Edmonton Oilers,2014/10/09  vs. CGY,CGY,1,66,34,32,12,0,20,28,48,28,20,8,0,12,20
Edmonton Oilers,2014/12/27  vs. CGY,CGY,1,47,41,6,1,0,5,-3,33,23,10,2,0,8,0
Edmonton Oilers,2014/12/31  vs. CGY,CGY,1,39,40,-1,-7,6,0,2,24,24,0,-1,1,0,3
Edmonton Oilers,2015/01/31  vs. CGY,CGY,1,46,59,-13,-6,-11,4,-4,28,45,-17,-5,-12,0,-4
Edmonton Oilers,2015/04/04  vs. CGY,CGY,1,66,56,10,3,0,7,14,49,39,10,2,0,8,10
Edmonton Oilers,2014/11/22  vs. CHI,CHI,1,39,35,4,2,0,2,4,26,26,0,2,0,-2,4
Edmonton Oilers,2015/01/09  vs. CHI,CHI,1,41,46,-5,7,-10,-2,0,25,27,-2,4,-4,-2,-1
Edmonton Oilers,2015/03/06  vs. CHI,CHI,1,64,71,-7,-2,-5,0,4,48,51,-3,0,-3,0,2
Edmonton Oilers,2015/01/02  vs. COL,COL,1,34,41,-7,-1,0,-6,-8,23,31,-8,-5,0,-3,-10
Edmonton Oilers,2015/03/25  vs. COL,COL,1,52,62,-10,0,-10,0,-2,39,47,-8,0,-8,0,-3
Edmonton Oilers,2015/03/30  vs. COL,COL,1,54,49,5,7,-2,0,5,46,42,4,5,-1,0,3
Edmonton Oilers,2014/11/25  vs. DAL,DAL,1,61,53,8,7,0,1,-1,40,40,0,2,0,-2,-4
Edmonton Oilers,2014/12/21  vs. DAL,DAL,1,39,63,-24,-3,-21,0,-2,29,47,-18,-3,-15,0,-1
Edmonton Oilers,2015/03/27  vs. DAL,DAL,1,41,67,-26,0,-26,0,-25,33,44,-11,0,-11,0,-16
Edmonton Oilers,2015/01/06  vs. DET,DET,1,32,59,-27,-16,-2,-9,-21,27,43,-16,-10,1,-7,-11
Edmonton Oilers,2015/03/09  vs. DET,DET,1,36,40,-4,-2,2,-4,-1,32,31,1,1,3,-3,1
Edmonton Oilers,2015/01/11  vs. FLA,FLA,1,48,42,6,-6,0,12,1,37,37,0,-5,0,5,1
Edmonton Oilers,2015/01/17  vs. FLA,FLA,1,40,47,-7,-5,1,-3,-5,32,41,-9,-6,1,-4,-7
Edmonton Oilers,2014/10/14  vs. LAK,LAK,1,45,38,7,0,0,7,-1,36,32,4,0,0,4,-1
Edmonton Oilers,2014/12/30  vs. LAK,LAK,1,35,59,-24,3,-27,0,-6,22,42,-20,1,-21,0,-4
Edmonton Oilers,2015/03/03  vs. LAK,LAK,1,41,40,1,-8,0,9,-14,29,29,0,-5,0,5,-11
Edmonton Oilers,2015/04/02  vs. LAK,LAK,1,46,55,-9,-6,0,-3,-8,37,40,-3,-3,0,0,-2
Edmonton Oilers,2015/04/07  vs. LAK,LAK,1,32,48,-16,-7,-9,0,-7,23,32,-9,-11,2,0,-9
Edmonton Oilers,2015/01/27  vs. MIN,MIN,1,47,55,-8,-6,0,-2,-10,33,40,-7,0,0,-7,-7
Edmonton Oilers,2015/02/20  vs. MIN,MIN,1,35,48,-13,1,0,-14,1,22,40,-18,3,0,-21,2
Edmonton Oilers,2015/02/24  vs. MIN,MIN,1,33,55,-22,4,-26,0,-13,24,36,-12,1,-13,0,-9
Edmonton Oilers,2014/10/27  vs. MTL,MTL,1,31,47,-16,1,-17,0,-2,21,31,-10,-3,-7,0,-4
Edmonton Oilers,2015/02/12  vs. MTL,MTL,1,44,42,2,-6,0,8,-4,37,28,9,0,0,9,4
Edmonton Oilers,2014/11/21  vs. NJD,NJD,1,52,31,21,15,0,6,14,34,26,8,9,0,-1,6
Edmonton Oilers,2015/02/09  vs. NJD,NJD,1,33,31,2,0,4,-2,-1,26,23,3,4,2,-3,1
Edmonton Oilers,2014/10/29  vs. NSH,NSH,1,54,49,5,-3,0,8,-2,34,37,-3,0,0,-3,-2
Edmonton Oilers,2014/11/11  vs. NSH,NSH,1,28,50,-22,-1,0,-21,-14,22,37,-15,1,0,-16,-9
Edmonton Oilers,2014/11/27  vs. NSH,NSH,1,46,42,4,4,0,0,4,35,30,5,5,0,0,5
Edmonton Oilers,2015/01/04  vs. NYI,NYI,1,49,52,-3,2,-5,0,11,28,40,-12,-1,-11,0,-3
Edmonton Oilers,2015/02/10  vs. NYI,NYI,1,42,48,-6,0,-3,-3,-3,33,35,-2,4,-3,-3,1
Edmonton Oilers,2014/11/09  vs. NYR,NYR,1,47,37,10,4,6,0,8,33,28,5,-2,7,0,6
Edmonton Oilers,2014/12/14  vs. NYR,NYR,1,42,42,0,-5,0,5,-7,25,33,-8,-2,0,-6,-10
Edmonton Oilers,2014/11/13  vs. OTT,OTT,1,35,32,3,0,0,3,-5,32,27,5,2,0,3,-4
Edmonton Oilers,2015/02/14  vs. OTT,OTT,1,40,57,-17,-3,0,-14,-5,30,47,-17,-3,0,-14,-5
Edmonton Oilers,2014/11/04  vs. PHI,PHI,1,58,53,5,1,0,4,-8,40,35,5,2,0,3,1
Edmonton Oilers,2015/03/21  vs. PHI,PHI,1,49,43,6,-6,10,2,8,34,30,4,-2,6,0,6
Edmonton Oilers,2015/02/04  vs. PIT,PIT,1,30,55,-25,-14,0,-11,-32,23,39,-16,-8,0,-8,-21
Edmonton Oilers,2015/03/12  vs. PIT,PIT,1,48,47,1,-3,0,4,-4,37,38,-1,-4,0,3,-4
Edmonton Oilers,2014/12/07  vs. SJS,SJS,1,36,31,5,13,-8,0,9,22,24,-2,4,-6,0,1
Edmonton Oilers,2014/12/09  vs. SJS,SJS,1,55,46,9,4,0,5,5,36,30,6,6,0,0,6
Edmonton Oilers,2014/12/18  vs. SJS,SJS,1,47,48,-1,3,-2,-2,3,34,33,1,2,1,-2,3
Edmonton Oilers,2015/02/02  vs. SJS,SJS,1,61,64,-3,5,-7,-1,0,49,54,-5,6,-9,-2,0
Edmonton Oilers,2015/04/09  vs. SJS,SJS,1,47,85,-38,-24,-13,-1,-31,34,63,-29,-16,-12,-1,-21
Edmonton Oilers,2014/11/28  vs. STL,STL,1,37,56,-19,-10,-7,-2,-11,25,47,-22,-11,-7,-4,-14
Edmonton Oilers,2015/01/13  vs. STL,STL,1,30,39,-9,-6,0,-3,-7,20,33,-13,-4,0,-9,-5
Edmonton Oilers,2015/02/28  vs. STL,STL,1,46,56,-10,-18,0,8,-15,31,42,-11,-16,0,5,-13
Edmonton Oilers,2014/10/20  vs. TBL,TBL,1,39,41,-2,8,-6,-4,2,30,27,3,6,1,-4,2
Edmonton Oilers,2015/01/15  vs. TBL,TBL,1,38,42,-4,-8,1,3,-10,29,29,0,-5,2,3,-6
Edmonton Oilers,2015/02/07  vs. TOR,TOR,1,58,54,4,-10,0,14,-12,45,43,2,-10,0,12,-10
Edmonton Oilers,2015/03/16  vs. TOR,TOR,1,40,34,6,1,5,0,4,32,29,3,0,3,0,3
Edmonton Oilers,2014/10/11  vs. VAN,VAN,1,36,43,-7,5,-12,0,-6,28,36,-8,3,-11,0,-7
Edmonton Oilers,2014/10/17  vs. VAN,VAN,1,40,47,-7,-14,0,7,-15,27,32,-5,-8,0,3,-9
Edmonton Oilers,2014/11/01  vs. VAN,VAN,1,41,42,-1,2,0,-3,1,30,37,-7,-1,-2,-4,-4
Edmonton Oilers,2014/11/19  vs. VAN,VAN,1,42,47,-5,-1,0,-4,-4,31,34,-3,0,0,-3,1
Edmonton Oilers,2015/04/11  vs. VAN,VAN,1,50,43,7,2,5,0,6,32,29,3,2,1,0,3
Edmonton Oilers,2014/12/03  vs. WPG,WPG,1,39,51,-12,-13,1,0,-13,29,31,-2,-2,1,-1,-3
Edmonton Oilers,2015/02/16  vs. WPG,WPG,1,24,53,-29,-24,-1,-4,-30,19,42,-23,-19,-2,-2,-24
Edmonton Oilers,2015/03/23  vs. WPG,WPG,1,44,49,-5,-4,0,-1,-6,37,29,8,-2,0,10,-3
Edmonton Oilers,2014/10/22  vs. WSH,WSH,1,30,55,-25,-7,-17,-1,-15,23,41,-18,-7,-10,-1,-14
Edmonton Oilers,2015/01/20  vs. WSH,WSH,1,35,50,-15,-2,0,-13,-6,22,31,-9,-2,0,-7,-5
Florida Panthers,2014/11/16  vs. ANA,ANA,1,49,67,-18,-3,-15,0,-7,42,48,-6,-3,-3,0,-7
Florida Panthers,2015/02/10  vs. ANA,ANA,1,27,50,-23,-4,-19,0,-4,23,36,-13,-3,-10,0,-3
Florida Panthers,2014/10/25  vs. ARI,ARI,1,34,46,-12,-11,-1,0,-11,29,34,-5,-5,0,0,-5
Florida Panthers,2014/10/30  vs. ARI,ARI,1,40,31,9,5,1,3,8,26,24,2,-2,3,1,-1
Florida Panthers,2014/11/04  vs. BOS,BOS,1,39,49,-10,-10,0,0,-10,28,37,-9,-9,0,0,-9
Florida Panthers,2015/03/21  vs. BOS,BOS,1,37,39,-2,-6,4,0,-2,30,32,-2,-6,4,0,-2
Florida Panthers,2015/03/31  vs. BOS,BOS,1,35,45,-10,-4,-2,-4,-7,24,30,-6,-2,-3,-1,-3
Florida Panthers,2015/04/09  vs. BOS,BOS,1,48,43,5,5,-3,3,8,35,37,-2,-2,-3,3,1
Florida Panthers,2014/10/17  vs. BUF,BUF,1,50,31,19,17,2,0,20,38,25,13,13,0,0,13
Florida Panthers,2014/12/06  vs. BUF,BUF,1,60,39,21,2,19,0,15,48,32,16,4,12,0,12
Florida Panthers,2014/12/13  vs. BUF,BUF,1,47,48,-1,-2,2,-1,-6,37,39,-2,-3,4,-3,-6
Florida Panthers,2015/01/02  vs. BUF,BUF,1,48,42,6,3,3,0,7,39,32,7,1,6,0,5
Florida Panthers,2015/02/28  vs. BUF,BUF,1,47,20,27,4,15,8,3,37,15,22,2,12,8,1
Florida Panthers,2014/11/26  vs. CAR,CAR,1,48,42,6,2,4,0,18,35,32,3,2,1,0,12
Florida Panthers,2015/03/14  vs. CAR,CAR,1,38,43,-5,2,-7,0,-1,25,32,-7,0,-7,0,-3
Florida Panthers,2015/04/02  vs. CAR,CAR,1,56,44,12,-6,18,0,-1,47,36,11,-6,17,0,-1
Florida Panthers,2014/12/01  vs. CBJ,CBJ,1,49,38,11,11,0,0,7,30,33,-3,0,0,-3,-5
Florida Panthers,2014/12/04  vs. CBJ,CBJ,1,71,26,45,22,0,23,27,50,21,29,18,0,11,21
Florida Panthers,2015/01/29  vs. CBJ,CBJ,1,40,42,-2,-7,5,0,-4,34,36,-2,-7,5,0,-4
Florida Panthers,2014/11/08  vs. CGY,CGY,1,49,33,16,6,11,-1,11,38,26,12,4,8,0,7
Florida Panthers,2015/01/09  vs. CGY,CGY,1,58,39,19,15,4,0,17,46,26,20,15,6,-1,17
Florida Panthers,2015/02/24  vs. CHI,CHI,1,39,47,-8,-5,0,-3,-9,29,35,-6,-3,0,-3,-8
Florida Panthers,2015/02/26  vs. CHI,CHI,1,39,33,6,0,0,6,-5,26,24,2,2,0,0,-1
Florida Panthers,2014/10/21  vs. COL,COL,1,51,34,17,11,5,1,13,41,30,11,8,3,0,7
Florida Panthers,2015/01/15  vs. COL,COL,1,51,35,16,14,0,2,13,36,29,7,6,0,1,5
Florida Panthers,2015/02/13  vs. DAL,DAL,1,43,45,-2,2,0,-4,-3,34,37,-3,2,0,-5,-2
Florida Panthers,2015/03/05  vs. DAL,DAL,1,26,52,-26,-5,-6,-15,-13,22,36,-14,-3,-2,-9,-6
Florida Panthers,2014/12/02  vs. DET,DET,1,43,44,-1,4,-10,5,3,35,32,3,3,-4,4,5
Florida Panthers,2014/12/12  vs. DET,DET,1,32,35,-3,-1,-3,1,-3,27,27,0,0,-1,1,0
Florida Panthers,2015/01/27  vs. DET,DET,1,40,49,-9,-3,-9,3,-15,31,38,-7,-1,-9,3,-11
Florida Panthers,2015/03/19  vs. DET,DET,1,36,46,-10,-6,-4,0,-4,32,39,-7,-7,0,0,-5
Florida Panthers,2015/01/11  vs. EDM,EDM,1,42,48,-6,6,-12,0,-1,37,37,0,5,-5,0,-1
Florida Panthers,2015/01/17  vs. EDM,EDM,1,47,40,7,5,3,-1,5,41,32,9,6,4,-1,7
Florida Panthers,2014/11/18  vs. LAK,LAK,1,41,38,3,5,0,-2,-1,31,30,1,3,0,-2,-2
Florida Panthers,2015/02/05  vs. LAK,LAK,1,28,42,-14,-13,0,-1,-10,23,30,-7,-6,0,-1,-4
Florida Panthers,2014/11/24  vs. MIN,MIN,1,37,49,-12,-2,0,-10,-14,29,42,-13,0,0,-13,-12
Florida Panthers,2015/02/12  vs. MIN,MIN,1,46,29,17,-1,0,18,9,29,24,5,-1,0,6,2
Florida Panthers,2014/12/30  vs. MTL,MTL,1,49,36,13,7,0,6,5,37,28,9,5,0,4,3
Florida Panthers,2015/02/19  vs. MTL,MTL,1,37,53,-16,-9,0,-7,-19,24,43,-19,-13,0,-6,-19
Florida Panthers,2015/03/17  vs. MTL,MTL,1,54,35,19,-1,0,20,6,42,30,12,-4,0,16,1
Florida Panthers,2015/03/28  vs. MTL,MTL,1,47,37,10,18,0,-8,10,28,24,4,11,0,-7,4
Florida Panthers,2015/04/05  vs. MTL,MTL,1,47,36,11,-3,0,14,0,30,30,0,-5,0,5,-4
Florida Panthers,2014/10/11  vs. NJD,NJD,1,30,22,8,0,0,8,-1,26,17,9,1,0,8,1
Florida Panthers,2015/01/31  vs. NJD,NJD,1,41,27,14,2,0,12,2,30,18,12,2,0,10,2
Florida Panthers,2015/04/11  vs. NJD,NJD,1,42,45,-3,1,0,-4,-3,29,37,-8,-2,-1,-5,-7
Florida Panthers,2014/11/22  vs. NSH,NSH,1,36,57,-21,-22,0,1,-20,30,49,-19,-21,0,2,-19
Florida Panthers,2015/02/08  vs. NSH,NSH,1,49,41,8,0,8,0,1,33,33,0,-4,4,0,-5
Florida Panthers,2014/11/14  vs. NYI,NYI,1,43,57,-14,-3,-6,-5,-12,32,36,-4,1,-3,-2,-5
Florida Panthers,2015/02/03  vs. NYI,NYI,1,49,58,-9,-5,-5,1,-3,33,41,-8,-5,-4,1,-3
Florida Panthers,2015/03/07  vs. NYI,NYI,1,27,42,-15,-14,-1,0,-16,18,31,-13,-11,-2,0,-14
Florida Panthers,2014/12/31  vs. NYR,NYR,1,40,44,-4,-2,0,-2,-2,26,37,-11,-4,0,-7,-5
Florida Panthers,2015/02/02  vs. NYR,NYR,1,59,47,12,4,-3,11,11,45,41,4,-2,-3,9,2
Florida Panthers,2015/03/15  vs. NYR,NYR,1,88,43,45,6,0,39,30,57,38,19,-3,0,22,11
Florida Panthers,2014/10/13  vs. OTT,OTT,1,42,29,13,11,0,2,15,32,24,8,8,0,0,12
Florida Panthers,2014/11/28  vs. OTT,OTT,1,60,34,26,14,-1,13,26,48,26,22,11,0,11,21
Florida Panthers,2015/02/21  vs. OTT,OTT,1,28,41,-13,-13,2,-2,-10,23,36,-13,-11,2,-4,-9
Florida Panthers,2015/03/29  vs. OTT,OTT,1,47,46,1,1,0,0,2,34,27,7,5,2,0,8
Florida Panthers,2014/11/01  vs. PHI,PHI,1,25,16,9,0,9,0,12,23,13,10,-1,11,0,11
Florida Panthers,2014/11/06  vs. PHI,PHI,1,45,45,0,-1,0,1,-3,34,34,0,0,0,0,-2
Florida Panthers,2014/12/18  vs. PHI,PHI,1,53,41,12,17,-5,0,12,38,28,10,13,-3,0,10
Florida Panthers,2014/12/20  vs. PIT,PIT,1,54,27,27,4,0,23,16,40,21,19,3,0,16,14
Florida Panthers,2014/12/22  vs. PIT,PIT,1,45,38,7,3,9,-5,-2,34,27,7,4,8,-5,-1
Florida Panthers,2015/02/22  vs. PIT,PIT,1,44,31,13,4,0,9,14,34,22,12,4,0,8,13
Florida Panthers,2014/11/11  vs. SJS,SJS,1,36,49,-13,-1,-12,0,0,31,36,-5,-2,-3,0,-1
Florida Panthers,2014/11/20  vs. SJS,SJS,1,39,54,-15,-7,-8,0,-19,24,33,-9,-6,-3,0,-14
Florida Panthers,2014/12/08  vs. STL,STL,1,42,31,11,1,0,10,3,35,24,11,2,0,9,5
Florida Panthers,2015/02/15  vs. STL,STL,1,38,49,-11,-18,0,7,-13,31,40,-9,-13,0,4,-9
Florida Panthers,2014/10/09  vs. TBL,TBL,1,28,41,-13,-12,1,-2,-11,21,31,-10,-9,1,-2,-8
Florida Panthers,2015/03/01  vs. TBL,TBL,1,41,43,-2,-3,1,0,8,28,37,-9,-8,-1,0,1
Florida Panthers,2015/03/24  vs. TBL,TBL,1,50,42,8,4,3,1,6,39,32,7,3,1,3,4
Florida Panthers,2015/04/04  vs. TBL,TBL,1,53,39,14,-3,0,17,3,44,30,14,-4,0,18,1
Florida Panthers,2014/12/28  vs. TOR,TOR,1,39,34,5,14,-7,-2,9,36,28,8,13,-3,-2,11
Florida Panthers,2015/02/17  vs. TOR,TOR,1,27,35,-8,2,-6,-4,1,18,26,-8,4,-10,-2,1
Florida Panthers,2015/03/03  vs. TOR,TOR,1,42,44,-2,-5,0,3,-4,35,34,1,-1,0,2,0
Florida Panthers,2015/03/26  vs. TOR,TOR,1,53,50,3,1,2,0,1,40,37,3,-2,5,0,-1
Florida Panthers,2015/01/08  vs. VAN,VAN,1,41,41,0,3,-4,1,0,33,34,-1,1,-1,-1,-1
Florida Panthers,2015/01/19  vs. VAN,VAN,1,35,30,5,-2,0,7,1,26,23,3,-2,0,5,0
Florida Panthers,2015/01/13  vs. WPG,WPG,1,35,53,-18,-3,0,-15,-1,28,41,-13,-3,0,-10,-1
Florida Panthers,2015/03/12  vs. WPG,WPG,1,33,36,-3,-4,1,0,-1,28,26,2,-3,5,0,0
Florida Panthers,2014/10/18  vs. WSH,WSH,1,35,49,-14,-6,0,-8,-16,25,35,-10,-4,0,-6,-10
Florida Panthers,2014/12/16  vs. WSH,WSH,1,43,41,2,8,-6,0,2,36,28,8,8,0,0,8
Florida Panthers,2015/01/04  vs. WSH,WSH,1,35,50,-15,-16,-1,2,-13,28,33,-5,-8,-2,5,-6
Los Angeles Kings,2014/11/12  vs. ANA,ANA,1,41,70,-29,-9,-20,0,-33,34,54,-20,-9,-11,0,-27
Los Angeles Kings,2014/11/15  vs. ANA,ANA,1,49,47,2,-5,0,7,-1,38,37,1,-5,0,6,-1
Los Angeles Kings,2015/01/17  vs. ANA,ANA,1,46,48,-2,4,-6,0,0,36,38,-2,2,-4,0,-1
Los Angeles Kings,2015/02/27  vs. ANA,ANA,1,53,46,7,5,3,-1,-2,37,39,-2,1,-2,-1,-10
Los Angeles Kings,2015/03/18  vs. ANA,ANA,1,47,35,12,4,-2,10,4,33,28,5,-1,0,6,1
Los Angeles Kings,2014/10/11  vs. ARI,ARI,1,46,46,0,6,-6,0,-2,28,41,-13,-3,-10,0,-14
Los Angeles Kings,2014/12/04  vs. ARI,ARI,1,64,43,21,-4,25,0,2,48,34,14,-2,16,0,-4
Los Angeles Kings,2014/12/20  vs. ARI,ARI,1,49,40,9,10,-3,2,12,40,30,10,10,-1,1,12
Los Angeles Kings,2015/03/16  vs. ARI,ARI,1,52,30,22,10,12,0,13,37,24,13,3,10,0,5
Los Angeles Kings,2014/12/02  vs. BOS,BOS,1,46,55,-9,1,-10,0,2,35,46,-11,-3,-8,0,-1
Los Angeles Kings,2015/01/31  vs. BOS,BOS,1,52,43,9,-2,0,11,-2,38,34,4,-1,0,5,-2
Los Angeles Kings,2014/10/23  vs. BUF,BUF,1,68,38,30,1,29,0,21,51,33,18,1,17,0,9
Los Angeles Kings,2014/12/09  vs. BUF,BUF,1,57,18,39,23,0,16,23,37,14,23,13,0,10,13
Los Angeles Kings,2014/11/02  vs. CAR,CAR,1,44,46,-2,-7,0,5,-14,33,36,-3,-1,0,-2,-10
Los Angeles Kings,2014/11/20  vs. CAR,CAR,1,53,39,14,4,10,0,15,40,31,9,4,5,0,9
Los Angeles Kings,2014/10/26  vs. CBJ,CBJ,1,50,38,12,4,6,2,7,39,30,9,3,4,2,4
Los Angeles Kings,2015/02/09  vs. CBJ,CBJ,1,62,36,26,1,26,-1,14,53,27,26,3,24,-1,14
Los Angeles Kings,2014/12/22  vs. CGY,CGY,1,65,45,20,-1,21,0,7,41,30,11,-1,12,0,4
Los Angeles Kings,2014/12/29  vs. CGY,CGY,1,57,31,26,-3,0,29,-1,37,20,17,1,0,16,3
Los Angeles Kings,2015/01/19  vs. CGY,CGY,1,46,29,17,17,0,0,17,31,19,12,10,2,0,10
Los Angeles Kings,2015/02/12  vs. CGY,CGY,1,74,33,41,6,26,9,33,53,19,34,4,21,9,26
Los Angeles Kings,2015/04/09  vs. CGY,CGY,1,67,37,30,3,0,27,4,43,30,13,-3,0,16,-3
Los Angeles Kings,2014/11/29  vs. CHI,CHI,1,45,39,6,-3,0,9,-6,35,34,1,-2,0,3,-6
Los Angeles Kings,2015/01/28  vs. CHI,CHI,1,39,41,-2,-1,0,-1,0,34,32,2,-1,0,3,1
Los Angeles Kings,2015/03/30  vs. CHI,CHI,1,44,54,-10,-5,0,-5,-14,33,42,-9,-4,0,-5,-9
Los Angeles Kings,2015/02/18  vs. COL,COL,1,43,48,-5,-1,-4,0,-2,30,39,-9,-1,-6,-2,-4
Los Angeles Kings,2015/03/10  vs. COL,COL,1,43,34,9,1,8,0,5,26,24,2,2,0,0,2
Los Angeles Kings,2015/04/04  vs. COL,COL,1,64,22,42,6,36,0,23,51,13,38,8,30,0,23
Los Angeles Kings,2014/11/04  vs. DAL,DAL,1,41,45,-4,-1,-1,-2,-3,31,34,-3,0,-2,-1,-1
Los Angeles Kings,2014/11/13  vs. DAL,DAL,1,42,38,4,-6,0,10,-3,34,29,5,-4,0,9,-3
Los Angeles Kings,2014/11/22  vs. DAL,DAL,1,55,30,25,0,0,25,-3,43,24,19,2,0,17,-1
Los Angeles Kings,2014/10/31  vs. DET,DET,1,30,41,-11,-10,0,-1,-6,24,31,-7,-6,0,-1,-2
Los Angeles Kings,2015/02/24  vs. DET,DET,1,32,30,2,2,0,0,3,27,20,7,3,4,0,8
Los Angeles Kings,2014/10/14  vs. EDM,EDM,1,38,45,-7,0,-7,0,1,32,36,-4,0,-4,0,1
Los Angeles Kings,2014/12/30  vs. EDM,EDM,1,59,35,24,-3,0,27,6,42,22,20,-1,0,21,4
Los Angeles Kings,2015/03/03  vs. EDM,EDM,1,40,41,-1,8,-9,0,14,29,29,0,5,-5,0,11
Los Angeles Kings,2015/04/02  vs. EDM,EDM,1,55,46,9,6,3,0,8,40,37,3,3,0,0,2
Los Angeles Kings,2015/04/07  vs. EDM,EDM,1,48,32,16,7,0,9,7,32,23,9,11,0,-2,9
Los Angeles Kings,2014/11/18  vs. FLA,FLA,1,38,41,-3,-5,2,0,1,30,31,-1,-3,2,0,2
Los Angeles Kings,2015/02/05  vs. FLA,FLA,1,42,28,14,13,1,0,10,30,23,7,6,1,0,4
Los Angeles Kings,2014/10/19  vs. MIN,MIN,1,26,45,-19,-6,-13,0,-13,20,39,-19,-7,-12,0,-15
Los Angeles Kings,2014/11/26  vs. MIN,MIN,1,32,46,-14,-1,-13,0,-3,26,38,-12,-2,-10,0,-3
Los Angeles Kings,2015/03/28  vs. MIN,MIN,1,59,30,29,0,0,29,5,38,23,15,0,0,15,2
Los Angeles Kings,2014/12/12  vs. MTL,MTL,1,61,36,25,-1,0,26,12,37,27,10,0,0,10,6
Los Angeles Kings,2015/03/05  vs. MTL,MTL,1,47,32,15,2,12,1,3,35,23,12,0,11,1,2
Los Angeles Kings,2015/01/14  vs. NJD,NJD,1,42,33,9,1,0,8,0,30,25,5,5,0,0,4
Los Angeles Kings,2015/03/23  vs. NJD,NJD,1,43,36,7,6,1,0,4,35,26,9,5,4,0,6
Los Angeles Kings,2014/11/25  vs. NSH,NSH,1,36,36,0,-2,10,-8,0,22,30,-8,-5,5,-8,-8
Los Angeles Kings,2015/01/03  vs. NSH,NSH,1,41,33,8,-4,-3,15,-10,32,27,5,-4,-1,10,-7
Los Angeles Kings,2015/03/14  vs. NSH,NSH,1,48,35,13,2,-3,14,-1,35,27,8,-1,2,7,-1
Los Angeles Kings,2014/11/06  vs. NYI,NYI,1,40,38,2,1,1,0,2,30,30,0,-4,4,0,0
Los Angeles Kings,2015/03/26  vs. NYI,NYI,1,59,43,16,22,-3,-3,19,40,28,12,16,-3,-1,15
Los Angeles Kings,2015/01/08  vs. NYR,NYR,1,45,39,6,-1,2,5,2,36,28,8,-1,5,4,3
Los Angeles Kings,2015/03/24  vs. NYR,NYR,1,59,51,8,15,-13,6,20,46,42,4,14,-12,2,15
Los Angeles Kings,2014/12/11  vs. OTT,OTT,1,52,52,0,-9,9,0,-6,39,34,5,-8,13,0,-6
Los Angeles Kings,2015/02/26  vs. OTT,OTT,1,56,36,20,15,0,5,15,43,27,16,10,0,6,10
Los Angeles Kings,2014/10/28  vs. PHI,PHI,1,61,58,3,2,0,1,9,47,47,0,2,0,-2,6
Los Angeles Kings,2014/12/06  vs. PHI,PHI,1,43,20,23,2,0,21,-1,32,18,14,0,0,14,-4
Los Angeles Kings,2014/10/30  vs. PIT,PIT,1,42,25,17,-1,0,18,-1,29,20,9,-1,0,10,-1
Los Angeles Kings,2015/03/07  vs. PIT,PIT,1,34,29,5,5,0,0,5,27,22,5,5,0,0,5
Los Angeles Kings,2014/10/08  vs. SJS,SJS,1,56,45,11,-5,0,16,6,43,34,9,-2,0,11,7
Los Angeles Kings,2014/12/27  vs. SJS,SJS,1,47,29,18,3,6,9,15,32,19,13,6,1,6,13
Los Angeles Kings,2015/01/21  vs. SJS,SJS,1,31,43,-12,-9,0,-3,-18,24,30,-6,-2,0,-4,-9
Los Angeles Kings,2015/02/21  vs. SJS,SJS,1,55,45,10,2,8,0,5,44,33,11,-1,12,0,2
Los Angeles Kings,2015/04/11  vs. SJS,SJS,1,51,24,27,3,5,19,22,38,22,16,0,6,10,10
Los Angeles Kings,2014/10/16  vs. STL,STL,1,33,53,-20,-20,0,0,-20,26,39,-13,-13,0,0,-13
Los Angeles Kings,2014/12/16  vs. STL,STL,1,28,32,-4,2,-5,-1,3,22,23,-1,1,-1,-1,3
Los Angeles Kings,2014/12/18  vs. STL,STL,1,50,37,13,9,5,-1,12,41,28,13,11,4,-2,12
Los Angeles Kings,2015/02/07  vs. TBL,TBL,1,37,41,-4,0,-4,0,-5,32,30,2,0,2,0,-2
Los Angeles Kings,2015/02/16  vs. TBL,TBL,1,43,35,8,13,2,-7,6,34,27,7,11,3,-7,4
Los Angeles Kings,2014/12/14  vs. TOR,TOR,1,62,38,24,6,6,12,13,45,27,18,5,5,8,11
Los Angeles Kings,2015/01/12  vs. TOR,TOR,1,43,37,6,1,5,0,5,37,24,13,1,12,0,10
Los Angeles Kings,2014/11/08  vs. VAN,VAN,1,53,26,27,1,26,0,4,47,20,27,2,25,0,5
Los Angeles Kings,2015/01/01  vs. VAN,VAN,1,61,28,33,8,1,24,16,47,19,28,8,1,19,16
Los Angeles Kings,2015/03/12  vs. VAN,VAN,1,47,36,11,2,9,0,2,29,25,4,-2,6,0,-2
Los Angeles Kings,2015/03/21  vs. VAN,VAN,1,43,54,-11,-10,-2,1,-12,24,41,-17,-13,-5,1,-18
Los Angeles Kings,2015/04/06  vs. VAN,VAN,1,42,45,-3,3,-6,0,-1,34,34,0,0,0,0,0
Los Angeles Kings,2014/10/12  vs. WPG,WPG,1,47,37,10,2,8,0,3,39,34,5,2,3,0,3
Los Angeles Kings,2015/01/10  vs. WPG,WPG,1,39,26,13,5,-2,10,15,31,23,8,5,-2,5,11
Los Angeles Kings,2015/03/01  vs. WPG,WPG,1,40,39,1,-1,0,2,2,29,34,-5,-4,0,-1,-6
Los Angeles Kings,2015/02/03  vs. WSH,WSH,1,42,35,7,-1,0,8,-5,33,28,5,-1,0,6,-4
Los Angeles Kings,2015/02/14  vs. WSH,WSH,1,56,37,19,25,-6,0,26,43,28,15,18,-3,0,21
Minnesota Wild,2014/10/17  vs. ANA,ANA,1,37,39,-2,2,-7,3,-3,26,30,-4,-2,-4,2,-5
Minnesota Wild,2014/12/05  vs. ANA,ANA,1,40,39,1,-1,2,0,-8,27,28,-1,-1,2,-2,-8
Minnesota Wild,2015/03/13  vs. ANA,ANA,1,36,28,8,6,0,2,4,30,19,11,7,0,4,8
Minnesota Wild,2014/10/23  vs. ARI,ARI,1,50,43,7,10,-3,0,9,34,31,3,8,-5,0,7
Minnesota Wild,2014/12/13  vs. ARI,ARI,1,51,60,-9,1,-1,-9,-8,35,40,-5,7,-1,-11,-1
Minnesota Wild,2015/01/17  vs. ARI,ARI,1,39,44,-5,-5,0,0,9,31,29,2,1,1,0,11
Minnesota Wild,2014/10/28  vs. BOS,BOS,1,64,44,20,2,-6,24,15,48,31,17,0,-1,18,11
Minnesota Wild,2014/12/17  vs. BOS,BOS,1,56,31,25,5,0,20,17,46,21,25,4,0,21,18
Minnesota Wild,2014/11/13  vs. BUF,BUF,1,57,27,30,2,21,7,13,41,23,18,1,12,5,9
Minnesota Wild,2015/01/15  vs. BUF,BUF,1,44,33,11,7,4,0,10,32,20,12,6,6,0,11
Minnesota Wild,2015/02/14  vs. CAR,CAR,1,31,52,-21,-1,-20,0,-10,27,36,-9,-1,-8,0,-9
Minnesota Wild,2015/03/06  vs. CAR,CAR,1,29,67,-38,-13,-25,0,-20,26,42,-16,-7,-9,0,-6
Minnesota Wild,2014/12/31  vs. CBJ,CBJ,1,39,33,6,0,0,6,0,32,28,4,0,2,2,2
Minnesota Wild,2015/01/19  vs. CBJ,CBJ,1,45,37,8,6,0,2,6,34,25,9,8,0,1,8
Minnesota Wild,2015/01/29  vs. CGY,CGY,1,55,57,-2,-4,2,0,-4,40,38,2,-1,3,0,2
Minnesota Wild,2015/02/18  vs. CGY,CGY,1,51,55,-4,0,-4,0,-7,31,41,-10,-5,-5,0,-14
Minnesota Wild,2015/03/27  vs. CGY,CGY,1,57,40,17,16,-6,7,23,42,32,10,8,-4,6,14
Minnesota Wild,2014/12/16  vs. CHI,CHI,1,41,46,-5,-10,3,2,-11,26,37,-11,-10,2,-3,-13
Minnesota Wild,2015/01/08  vs. CHI,CHI,1,60,23,37,3,0,34,19,42,18,24,2,0,22,14
Minnesota Wild,2015/01/11  vs. CHI,CHI,1,52,55,-3,-4,0,1,-6,41,39,2,-4,0,6,-6
Minnesota Wild,2015/02/03  vs. CHI,CHI,1,53,40,13,2,11,0,3,40,31,9,2,7,0,4
Minnesota Wild,2015/04/07  vs. CHI,CHI,1,53,53,0,-2,2,0,-2,44,36,8,5,3,0,5
Minnesota Wild,2014/10/09  vs. COL,COL,1,64,23,41,14,27,0,19,57,18,39,14,25,0,19
Minnesota Wild,2014/10/11  vs. COL,COL,1,26,35,-9,1,-10,0,-2,19,26,-7,1,-8,0,-5
Minnesota Wild,2015/02/07  vs. COL,COL,1,53,31,22,15,7,0,23,39,19,20,12,8,0,21
Minnesota Wild,2015/02/28  vs. COL,COL,1,48,41,7,5,2,0,6,34,28,6,2,4,0,5
Minnesota Wild,2015/03/08  vs. COL,COL,1,52,23,29,15,0,14,19,37,18,19,10,0,9,13
Minnesota Wild,2014/11/01  vs. DAL,DAL,1,40,43,-3,2,-5,0,2,32,24,8,5,3,0,13
Minnesota Wild,2014/11/15  vs. DAL,DAL,1,48,60,-12,-1,-4,-7,-8,33,38,-5,0,-1,-4,-4
Minnesota Wild,2014/11/28  vs. DAL,DAL,1,50,67,-17,-2,-17,2,-10,37,50,-13,-1,-13,1,-10
Minnesota Wild,2015/01/03  vs. DAL,DAL,1,30,56,-26,-6,0,-20,-21,20,42,-22,-4,0,-18,-14
Minnesota Wild,2015/02/22  vs. DAL,DAL,1,41,29,12,10,-2,4,13,33,20,13,8,2,3,10
Minnesota Wild,2015/01/20  vs. DET,DET,1,33,36,-3,-5,0,2,-4,26,26,0,-3,0,3,-2
Minnesota Wild,2015/04/04  vs. DET,DET,1,33,45,-12,-7,-1,-4,-7,27,29,-2,0,0,-2,0
Minnesota Wild,2015/01/27  vs. EDM,EDM,1,55,47,8,6,2,0,10,40,33,7,0,7,0,7
Minnesota Wild,2015/02/20  vs. EDM,EDM,1,48,35,13,-1,14,0,-1,40,22,18,-3,21,0,-2
Minnesota Wild,2015/02/24  vs. EDM,EDM,1,55,33,22,-4,0,26,13,36,24,12,-1,0,13,9
Minnesota Wild,2014/11/24  vs. FLA,FLA,1,49,37,12,2,10,0,14,42,29,13,0,13,0,12
Minnesota Wild,2015/02/12  vs. FLA,FLA,1,29,46,-17,1,-18,0,-9,24,29,-5,1,-6,0,-2
Minnesota Wild,2014/10/19  vs. LAK,LAK,1,45,26,19,6,0,13,13,39,20,19,7,0,12,15
Minnesota Wild,2014/11/26  vs. LAK,LAK,1,46,32,14,1,0,13,3,38,26,12,2,0,10,3
Minnesota Wild,2015/03/28  vs. LAK,LAK,1,30,59,-29,0,-29,0,-5,23,38,-15,0,-15,0,-2
Minnesota Wild,2014/11/08  vs. MTL,MTL,1,64,43,21,16,0,5,21,41,34,7,13,0,-6,12
Minnesota Wild,2014/12/03  vs. MTL,MTL,1,49,41,8,0,8,0,13,39,26,13,0,13,0,13
Minnesota Wild,2014/11/11  vs. NJD,NJD,1,29,24,5,1,0,4,-2,24,21,3,1,0,2,-2
Minnesota Wild,2015/03/10  vs. NJD,NJD,1,61,44,17,5,12,0,7,49,40,9,4,5,0,6
Minnesota Wild,2014/12/20  vs. NSH,NSH,1,40,57,-17,-13,-2,-2,-15,28,43,-15,-10,-3,-2,-14
Minnesota Wild,2015/01/10  vs. NSH,NSH,1,51,40,11,3,0,8,2,39,28,11,6,0,5,4
Minnesota Wild,2015/02/26  vs. NSH,NSH,1,36,45,-9,-9,0,0,-4,31,32,-1,-7,6,0,0
Minnesota Wild,2015/03/17  vs. NSH,NSH,1,35,40,-5,-2,-4,1,-9,25,24,1,3,-3,1,-2
Minnesota Wild,2015/04/09  vs. NSH,NSH,1,37,40,-3,-10,1,6,-11,24,31,-7,-8,1,0,-9
Minnesota Wild,2014/12/09  vs. NYI,NYI,1,54,35,19,-1,-2,22,-2,35,25,10,-5,-2,17,-6
Minnesota Wild,2015/03/24  vs. NYI,NYI,1,56,66,-10,-18,0,8,-19,39,46,-7,-11,0,4,-12
Minnesota Wild,2014/10/27  vs. NYR,NYR,1,31,27,4,1,6,-3,2,26,22,4,2,5,-3,3
Minnesota Wild,2015/04/02  vs. NYR,NYR,1,36,28,8,2,0,6,1,33,23,10,2,0,8,5
Minnesota Wild,2014/11/06  vs. OTT,OTT,1,42,23,19,7,0,12,10,32,16,16,5,0,11,7
Minnesota Wild,2015/03/03  vs. OTT,OTT,1,48,38,10,10,0,0,9,37,25,12,12,0,0,11
Minnesota Wild,2014/11/20  vs. PHI,PHI,1,31,46,-15,-15,0,0,-14,25,30,-5,-10,5,0,-9
Minnesota Wild,2014/12/23  vs. PHI,PHI,1,35,41,-6,-7,0,1,-3,24,32,-8,-8,0,0,-5
Minnesota Wild,2014/11/04  vs. PIT,PIT,1,44,37,7,-2,0,9,-3,31,27,4,1,0,3,0
Minnesota Wild,2015/01/13  vs. PIT,PIT,1,55,55,0,4,0,-4,1,41,38,3,2,0,1,1
Minnesota Wild,2014/10/30  vs. SJS,SJS,1,64,41,23,7,0,16,21,52,25,27,8,0,19,24
Minnesota Wild,2014/12/11  vs. SJS,SJS,1,40,55,-15,-15,0,0,-21,25,41,-16,-13,0,-3,-18
Minnesota Wild,2015/01/06  vs. SJS,SJS,1,37,40,-3,-9,7,-1,-8,28,31,-3,-10,7,0,-8
Minnesota Wild,2014/11/29  vs. STL,STL,1,53,32,21,16,3,2,18,42,25,17,12,4,1,13
Minnesota Wild,2015/03/14  vs. STL,STL,1,27,63,-36,-34,-1,-1,-35,19,47,-28,-29,2,-1,-30
Minnesota Wild,2015/03/21  vs. STL,STL,1,36,46,-10,-7,-3,0,-5,28,34,-6,-4,-2,0,-2
Minnesota Wild,2015/04/11  vs. STL,STL,1,33,41,-8,2,0,-10,0,20,27,-7,4,0,-11,2
Minnesota Wild,2014/10/25  vs. TBL,TBL,1,33,39,-6,0,-6,0,-4,27,30,-3,0,-3,0,-3
Minnesota Wild,2014/11/22  vs. TBL,TBL,1,46,53,-7,-11,1,3,-10,34,39,-5,-8,5,-2,-3
Minnesota Wild,2015/01/02  vs. TOR,TOR,1,41,46,-5,-3,-2,0,-7,31,38,-7,-8,1,0,-8
Minnesota Wild,2015/03/23  vs. TOR,TOR,1,47,49,-2,3,-5,0,15,35,38,-3,-2,-1,0,10
Minnesota Wild,2015/02/01  vs. VAN,VAN,1,26,42,-16,-6,-10,0,-5,23,32,-9,-4,-5,0,-3
Minnesota Wild,2015/02/09  vs. VAN,VAN,1,39,48,-9,-5,-4,0,4,29,38,-9,-6,-3,0,0
Minnesota Wild,2015/02/16  vs. VAN,VAN,1,45,43,2,-1,-4,7,-5,27,35,-8,-4,-4,0,-8
Minnesota Wild,2014/11/16  vs. WPG,WPG,1,25,32,-7,4,-11,0,5,21,21,0,3,-3,0,3
Minnesota Wild,2014/12/27  vs. WPG,WPG,1,38,41,-3,-5,2,0,-3,28,27,1,-4,5,0,1
Minnesota Wild,2014/12/29  vs. WPG,WPG,1,51,50,1,12,-11,0,19,35,29,6,10,-5,1,13
Minnesota Wild,2015/02/10  vs. WPG,WPG,1,32,54,-22,-21,0,-1,-21,27,36,-9,-8,0,-1,-8
Minnesota Wild,2015/04/06  vs. WPG,WPG,1,48,39,9,-3,0,12,-3,34,34,0,-5,0,5,-9
Minnesota Wild,2015/03/05  vs. WSH,WSH,1,53,42,11,1,-4,14,8,38,32,6,1,-2,7,4
Minnesota Wild,2015/03/19  vs. WSH,WSH,1,36,37,-1,-5,0,4,-5,26,28,-2,-3,0,1,-3
Montreal Canadiens,2014/12/18  vs. ANA,ANA,1,42,49,-7,-15,0,8,-3,29,31,-2,-7,0,5,1
Montreal Canadiens,2015/03/04  vs. ANA,ANA,1,50,51,-1,-4,0,3,4,37,41,-4,-3,0,-1,2
Montreal Canadiens,2015/02/01  vs. ARI,ARI,1,41,44,-3,-3,-9,9,-5,27,32,-5,-2,-6,3,-3
Montreal Canadiens,2015/03/07  vs. ARI,ARI,1,57,59,-2,13,-15,0,15,44,42,2,12,-10,0,13
Montreal Canadiens,2014/10/16  vs. BOS,BOS,1,39,44,-5,-2,-3,0,-4,25,27,-2,-2,-1,1,0
Montreal Canadiens,2014/11/13  vs. BOS,BOS,1,39,40,-1,-5,-1,5,0,29,22,7,-3,6,4,2
Montreal Canadiens,2014/11/22  vs. BOS,BOS,1,36,52,-16,-6,-10,0,-14,27,43,-16,-4,-12,0,-16
Montreal Canadiens,2015/02/08  vs. BOS,BOS,1,48,69,-21,-3,-18,0,-11,37,48,-11,-1,-10,0,-1
Montreal Canadiens,2014/11/05  vs. BUF,BUF,1,50,32,18,17,1,0,17,38,26,12,11,1,0,11
Montreal Canadiens,2014/11/28  vs. BUF,BUF,1,49,41,8,13,0,-5,7,35,28,7,9,0,-2,7
Montreal Canadiens,2014/11/29  vs. BUF,BUF,1,76,31,45,28,1,16,44,52,24,28,17,1,10,27
Montreal Canadiens,2015/02/03  vs. BUF,BUF,1,78,40,38,-2,0,40,-3,48,26,22,1,0,21,0
Montreal Canadiens,2014/12/16  vs. CAR,CAR,1,37,44,-7,0,-7,0,0,27,32,-5,5,-10,0,3
Montreal Canadiens,2014/12/29  vs. CAR,CAR,1,32,43,-11,-1,-10,0,-8,25,29,-4,3,-7,0,-1
Montreal Canadiens,2015/03/19  vs. CAR,CAR,1,40,48,-8,2,-10,0,7,23,33,-10,1,-11,0,5
Montreal Canadiens,2015/01/14  vs. CBJ,CBJ,1,42,31,11,1,0,10,11,30,25,5,1,-1,5,6
Montreal Canadiens,2015/02/21  vs. CBJ,CBJ,1,42,53,-11,-4,-7,0,-6,24,33,-9,-1,-8,0,-8
Montreal Canadiens,2015/02/26  vs. CBJ,CBJ,1,39,40,-1,1,-2,0,5,31,30,1,1,0,0,6
Montreal Canadiens,2014/10/28  vs. CGY,CGY,1,33,40,-7,-7,0,0,-7,20,30,-10,-8,0,-2,-10
Montreal Canadiens,2014/11/02  vs. CGY,CGY,1,44,39,5,2,0,3,-10,23,29,-6,1,0,-7,-9
Montreal Canadiens,2014/11/04  vs. CHI,CHI,1,39,52,-13,4,0,-17,4,28,33,-5,3,0,-8,5
Montreal Canadiens,2014/12/05  vs. CHI,CHI,1,51,49,2,6,1,-5,3,42,32,10,12,0,-2,11
Montreal Canadiens,2014/10/18  vs. COL,COL,1,56,41,15,2,2,11,13,38,32,6,-1,-2,9,6
Montreal Canadiens,2014/12/01  vs. COL,COL,1,51,45,6,3,4,-1,6,38,34,4,3,1,0,6
Montreal Canadiens,2014/12/06  vs. DAL,DAL,1,33,45,-12,-15,0,3,-15,19,33,-14,-8,0,-6,-9
Montreal Canadiens,2015/01/27  vs. DAL,DAL,1,29,56,-27,1,-28,0,-9,20,41,-21,-1,-20,0,-10
Montreal Canadiens,2014/10/21  vs. DET,DET,1,46,41,5,-9,0,14,-4,34,27,7,1,0,6,3
Montreal Canadiens,2014/11/16  vs. DET,DET,1,32,32,0,4,-4,0,6,26,24,2,4,-2,0,6
Montreal Canadiens,2015/02/16  vs. DET,DET,1,32,47,-15,-16,1,0,-16,25,31,-6,-7,1,0,-7
Montreal Canadiens,2015/04/09  vs. DET,DET,1,36,33,3,-3,1,5,3,30,26,4,-4,1,7,3
Montreal Canadiens,2014/10/27  vs. EDM,EDM,1,47,31,16,-1,0,17,2,31,21,10,3,0,7,4
Montreal Canadiens,2015/02/12  vs. EDM,EDM,1,42,44,-2,6,-8,0,4,28,37,-9,0,-9,0,-4
Montreal Canadiens,2014/12/30  vs. FLA,FLA,1,36,49,-13,-7,-6,0,-5,28,37,-9,-5,-4,0,-3
Montreal Canadiens,2015/02/19  vs. FLA,FLA,1,53,37,16,9,7,0,19,43,24,19,13,6,0,19
Montreal Canadiens,2015/03/17  vs. FLA,FLA,1,35,54,-19,1,-20,0,-6,30,42,-12,4,-16,0,-1
Montreal Canadiens,2015/03/28  vs. FLA,FLA,1,37,47,-10,-18,8,0,-10,24,28,-4,-11,7,0,-4
Montreal Canadiens,2015/04/05  vs. FLA,FLA,1,36,47,-11,3,-14,0,0,30,30,0,5,-5,0,4
Montreal Canadiens,2014/12/12  vs. LAK,LAK,1,36,61,-25,1,-26,0,-12,27,37,-10,0,-10,0,-6
Montreal Canadiens,2015/03/05  vs. LAK,LAK,1,32,47,-15,-2,-1,-12,-3,23,35,-12,0,-1,-11,-2
Montreal Canadiens,2014/11/08  vs. MIN,MIN,1,43,64,-21,-16,-5,0,-21,34,41,-7,-13,6,0,-12
Montreal Canadiens,2014/12/03  vs. MIN,MIN,1,41,49,-8,0,0,-8,-13,26,39,-13,0,0,-13,-13
Montreal Canadiens,2015/01/02  vs. NJD,NJD,1,29,32,-3,-1,-2,0,3,26,26,0,2,-2,0,4
Montreal Canadiens,2015/02/07  vs. NJD,NJD,1,65,40,25,3,8,14,23,48,29,19,1,7,11,15
Montreal Canadiens,2015/04/03  vs. NJD,NJD,1,28,28,0,-1,-2,3,0,25,18,7,2,2,3,7
Montreal Canadiens,2015/01/20  vs. NSH,NSH,1,47,55,-8,-12,0,4,-8,30,42,-12,-15,0,3,-12
Montreal Canadiens,2015/03/24  vs. NSH,NSH,1,51,47,4,15,-11,0,6,33,34,-1,10,-10,-1,2
Montreal Canadiens,2014/12/23  vs. NYI,NYI,1,39,61,-22,-7,-12,-3,-10,27,40,-13,-6,-4,-3,-6
Montreal Canadiens,2015/01/17  vs. NYI,NYI,1,50,51,-1,-1,0,0,-13,37,32,5,0,5,0,-8
Montreal Canadiens,2015/03/14  vs. NYI,NYI,1,31,48,-17,-7,-10,0,-6,25,30,-5,-1,-4,0,0
Montreal Canadiens,2014/10/25  vs. NYR,NYR,1,47,54,-7,1,-8,0,2,35,41,-6,1,-7,0,0
Montreal Canadiens,2014/11/23  vs. NYR,NYR,1,39,50,-11,-4,0,-7,-1,30,35,-5,-1,0,-4,3
Montreal Canadiens,2015/01/29  vs. NYR,NYR,1,41,36,5,6,-1,0,6,35,28,7,8,-1,0,8
Montreal Canadiens,2014/12/20  vs. OTT,OTT,1,46,47,-1,-5,-3,7,0,32,31,1,-6,0,7,-1
Montreal Canadiens,2015/01/15  vs. OTT,OTT,1,39,48,-9,-5,0,-4,-7,25,36,-11,-3,0,-8,-7
Montreal Canadiens,2015/02/18  vs. OTT,OTT,1,52,54,-2,-6,0,4,-8,44,40,4,1,0,3,-1
Montreal Canadiens,2015/03/12  vs. OTT,OTT,1,42,51,-9,-3,3,-9,-2,31,35,-4,-1,4,-7,0
Montreal Canadiens,2014/10/11  vs. PHI,PHI,1,79,42,37,-3,0,40,-4,50,25,25,2,0,23,1
Montreal Canadiens,2014/11/15  vs. PHI,PHI,1,39,47,-8,-3,-5,0,-3,29,32,-3,-2,-1,0,-2
Montreal Canadiens,2015/02/10  vs. PHI,PHI,1,66,37,29,4,0,25,21,49,25,24,3,0,21,15
Montreal Canadiens,2014/11/18  vs. PIT,PIT,1,52,44,8,1,0,7,0,30,28,2,-2,0,4,-2
Montreal Canadiens,2015/01/03  vs. PIT,PIT,1,36,59,-23,0,-23,0,-8,30,43,-13,0,-13,0,-5
Montreal Canadiens,2015/01/10  vs. PIT,PIT,1,38,46,-8,-5,-3,0,-8,27,31,-4,-1,-3,0,-4
Montreal Canadiens,2015/03/02  vs. SJS,SJS,1,47,67,-20,-3,0,-17,-8,30,46,-16,-2,0,-14,-3
Montreal Canadiens,2015/03/21  vs. SJS,SJS,1,51,58,-7,-1,-6,0,3,33,38,-5,2,-7,0,3
Montreal Canadiens,2014/11/20  vs. STL,STL,1,54,54,0,3,-10,7,11,39,42,-3,3,-7,1,5
Montreal Canadiens,2015/02/24  vs. STL,STL,1,37,52,-15,2,-17,0,-2,30,40,-10,5,-15,0,2
Montreal Canadiens,2014/10/13  vs. TBL,TBL,1,41,43,-2,4,0,-6,0,28,37,-9,3,0,-12,-3
Montreal Canadiens,2015/01/06  vs. TBL,TBL,1,30,48,-18,-5,-1,-12,-9,22,34,-12,-4,0,-8,-5
Montreal Canadiens,2015/03/10  vs. TBL,TBL,1,36,59,-23,-23,0,0,-23,23,33,-10,-10,0,0,-10
Montreal Canadiens,2015/03/16  vs. TBL,TBL,1,41,40,1,-3,0,4,2,35,30,5,-3,0,8,3
Montreal Canadiens,2015/03/30  vs. TBL,TBL,1,42,47,-5,6,0,-11,-11,23,38,-15,1,0,-16,-14
Montreal Canadiens,2014/10/08  vs. TOR,TOR,1,50,44,6,6,1,-1,9,41,30,11,8,4,-1,11
Montreal Canadiens,2015/02/14  vs. TOR,TOR,1,45,35,10,9,0,1,10,31,23,8,7,0,1,8
Montreal Canadiens,2015/02/28  vs. TOR,TOR,1,29,51,-22,-3,-19,0,-6,20,35,-15,-3,-12,0,-1
Montreal Canadiens,2015/04/11  vs. TOR,TOR,1,49,39,10,15,0,-5,10,34,29,5,11,0,-6,5
Montreal Canadiens,2014/10/30  vs. VAN,VAN,1,38,51,-13,-8,0,-5,-10,28,39,-11,-6,0,-5,-8
Montreal Canadiens,2014/12/09  vs. VAN,VAN,1,49,23,26,18,8,0,22,31,15,16,8,8,0,13
Montreal Canadiens,2014/11/11  vs. WPG,WPG,1,34,50,-16,-7,-9,0,-9,27,36,-9,-4,-5,0,-3
Montreal Canadiens,2015/03/26  vs. WPG,WPG,1,39,42,-3,2,0,-5,1,32,30,2,2,0,0,5
Montreal Canadiens,2014/10/09  vs. WSH,WSH,1,27,41,-14,-6,0,-8,-13,18,30,-12,-2,0,-10,-11
Montreal Canadiens,2015/01/31  vs. WSH,WSH,1,44,48,-4,-4,0,0,-4,27,32,-5,-5,0,0,-5
Montreal Canadiens,2015/04/02  vs. WSH,WSH,1,48,33,15,7,2,6,9,25,17,8,5,1,2,5
Nashville Predators,2015/01/04  vs. ANA,ANA,1,33,54,-21,-5,-9,-7,-12,25,41,-16,-7,-2,-7,-14
Nashville Predators,2015/02/05  vs. ANA,ANA,1,53,25,28,1,0,27,3,44,20,24,1,0,23,2
Nashville Predators,2015/03/15  vs. ANA,ANA,1,42,34,8,11,-6,3,15,28,25,3,6,-5,2,10
Nashville Predators,2014/10/21  vs. ARI,ARI,1,36,39,-3,-5,4,-2,-3,26,28,-2,-3,1,0,-2
Nashville Predators,2014/12/11  vs. ARI,ARI,1,46,52,-6,-3,-3,0,-6,34,38,-4,-2,-1,-1,-5
Nashville Predators,2015/03/09  vs. ARI,ARI,1,49,52,-3,12,-15,0,6,38,37,1,7,-6,0,5
Nashville Predators,2014/12/16  vs. BOS,BOS,1,47,36,11,3,4,4,7,35,26,9,5,3,1,6
Nashville Predators,2014/12/23  vs. BOS,BOS,1,37,34,3,-1,0,4,-9,30,24,6,0,0,6,-5
Nashville Predators,2015/02/22  vs. BUF,BUF,1,58,20,38,33,0,5,32,39,14,25,22,0,3,21
Nashville Predators,2015/03/21  vs. BUF,BUF,1,72,36,36,30,6,0,31,60,30,30,28,2,0,28
Nashville Predators,2014/12/02  vs. CAR,CAR,1,53,54,-1,-4,0,3,-12,41,33,8,3,0,5,-2
Nashville Predators,2015/01/06  vs. CAR,CAR,1,48,42,6,-2,-2,10,3,37,28,9,0,-1,10,5
Nashville Predators,2014/11/29  vs. CBJ,CBJ,1,60,29,31,26,5,0,31,43,21,22,18,4,0,21
Nashville Predators,2014/12/22  vs. CBJ,CBJ,1,48,46,2,-2,4,0,2,37,35,2,-1,3,0,2
Nashville Predators,2014/10/14  vs. CGY,CGY,1,37,50,-13,-10,2,-5,-13,25,30,-5,-7,2,0,-5
Nashville Predators,2014/10/31  vs. CGY,CGY,1,81,44,37,23,1,13,26,47,34,13,11,0,2,11
Nashville Predators,2015/03/29  vs. CGY,CGY,1,50,54,-4,-4,1,-1,-7,34,39,-5,-4,3,-4,-5
Nashville Predators,2014/10/18  vs. CHI,CHI,1,39,44,-5,-3,0,-2,-5,24,32,-8,-7,0,-1,-8
Nashville Predators,2014/10/23  vs. CHI,CHI,1,48,46,2,9,-9,2,14,37,33,4,9,-6,1,13
Nashville Predators,2014/12/06  vs. CHI,CHI,1,51,47,4,-3,0,7,0,40,36,4,-1,0,5,2
Nashville Predators,2014/12/29  vs. CHI,CHI,1,43,50,-7,8,-15,0,5,35,36,-1,8,-9,0,8
Nashville Predators,2014/12/09  vs. COL,COL,1,36,52,-16,1,-17,0,-10,28,33,-5,1,-6,0,-5
Nashville Predators,2015/01/27  vs. COL,COL,1,71,33,38,-1,28,11,17,52,27,25,-3,22,6,10
Nashville Predators,2015/01/30  vs. COL,COL,1,52,35,17,-3,0,20,5,32,28,4,-5,0,9,0
Nashville Predators,2015/02/24  vs. COL,COL,1,58,33,25,6,20,-1,10,47,22,25,8,18,-1,11
Nashville Predators,2015/04/07  vs. COL,COL,1,68,31,37,9,14,14,25,45,22,23,3,11,9,15
Nashville Predators,2014/10/11  vs. DAL,DAL,1,45,37,8,0,3,5,5,31,27,4,0,3,1,1
Nashville Predators,2014/11/06  vs. DAL,DAL,1,64,61,3,15,-12,0,16,45,49,-4,5,-9,0,3
Nashville Predators,2015/01/08  vs. DAL,DAL,1,51,35,16,12,4,0,16,33,23,10,5,5,0,10
Nashville Predators,2015/04/04  vs. DAL,DAL,1,61,40,21,14,-1,8,13,46,26,20,13,3,4,16
Nashville Predators,2015/04/11  vs. DAL,DAL,1,51,53,-2,0,0,-2,-4,30,36,-6,1,0,-7,-6
Nashville Predators,2015/01/17  vs. DET,DET,1,43,36,7,1,0,6,2,35,27,8,1,0,7,2
Nashville Predators,2015/02/28  vs. DET,DET,1,38,40,-2,-4,5,-3,-3,33,26,7,3,5,-1,4
Nashville Predators,2014/10/29  vs. EDM,EDM,1,49,54,-5,3,-8,0,2,37,34,3,0,3,0,2
Nashville Predators,2014/11/11  vs. EDM,EDM,1,50,28,22,1,21,0,14,37,22,15,-1,16,0,9
Nashville Predators,2014/11/27  vs. EDM,EDM,1,42,46,-4,-4,0,0,-4,30,35,-5,-5,0,0,-5
Nashville Predators,2014/11/22  vs. FLA,FLA,1,57,36,21,22,-1,0,20,49,30,19,21,-2,0,19
Nashville Predators,2015/02/08  vs. FLA,FLA,1,41,49,-8,0,0,-8,-1,33,33,0,4,0,-4,5
Nashville Predators,2014/11/25  vs. LAK,LAK,1,36,36,0,2,8,-10,0,30,22,8,5,8,-5,8
Nashville Predators,2015/01/03  vs. LAK,LAK,1,33,41,-8,4,-15,3,10,27,32,-5,4,-10,1,7
Nashville Predators,2015/03/14  vs. LAK,LAK,1,35,48,-13,-2,-14,3,1,27,35,-8,1,-7,-2,1
Nashville Predators,2014/12/20  vs. MIN,MIN,1,57,40,17,13,2,2,15,43,28,15,10,2,3,14
Nashville Predators,2015/01/10  vs. MIN,MIN,1,40,51,-11,-3,-8,0,-2,28,39,-11,-6,-5,0,-4
Nashville Predators,2015/02/26  vs. MIN,MIN,1,45,36,9,9,0,0,4,32,31,1,7,0,-6,0
Nashville Predators,2015/03/17  vs. MIN,MIN,1,40,35,5,2,-1,4,9,24,25,-1,-3,-1,3,2
Nashville Predators,2015/04/09  vs. MIN,MIN,1,40,37,3,10,-6,-1,11,31,24,7,8,0,-1,9
Nashville Predators,2015/01/20  vs. MTL,MTL,1,55,47,8,12,-4,0,8,42,30,12,15,-3,0,12
Nashville Predators,2015/03/24  vs. MTL,MTL,1,47,51,-4,-15,0,11,-6,34,33,1,-10,1,10,-2
Nashville Predators,2015/02/14  vs. NJD,NJD,1,60,35,25,8,17,0,23,43,28,15,8,7,0,13
Nashville Predators,2015/03/03  vs. NJD,NJD,1,51,37,14,0,0,14,8,38,30,8,0,0,8,4
Nashville Predators,2015/02/19  vs. NYI,NYI,1,49,55,-6,0,0,-6,4,29,44,-15,-1,0,-14,-1
Nashville Predators,2015/03/05  vs. NYI,NYI,1,65,48,17,12,0,5,8,51,34,17,10,0,7,11
Nashville Predators,2015/02/07  vs. NYR,NYR,1,47,49,-2,3,-5,0,3,36,38,-2,4,-5,-1,3
Nashville Predators,2015/03/02  vs. NYR,NYR,1,47,54,-7,0,0,-7,-7,37,49,-12,-2,0,-10,-12
Nashville Predators,2014/10/09  vs. OTT,OTT,1,53,31,22,11,1,10,21,45,25,20,8,2,10,18
Nashville Predators,2014/11/20  vs. OTT,OTT,1,45,40,5,-1,-2,8,-8,38,28,10,-1,-1,12,-5
Nashville Predators,2014/12/27  vs. PHI,PHI,1,35,30,5,5,0,0,9,25,23,2,1,1,0,6
Nashville Predators,2015/02/21  vs. PHI,PHI,1,36,48,-12,3,0,-15,-12,24,36,-12,2,0,-14,-12
Nashville Predators,2014/10/25  vs. PIT,PIT,1,42,31,11,5,0,6,-5,27,24,3,4,0,-1,-9
Nashville Predators,2015/02/01  vs. PIT,PIT,1,33,36,-3,2,-5,0,2,25,21,4,1,3,0,1
Nashville Predators,2014/12/13  vs. SJS,SJS,1,51,52,-1,-3,0,2,-18,32,40,-8,-4,0,-4,-20
Nashville Predators,2015/02/17  vs. SJS,SJS,1,50,60,-10,2,-5,-7,-5,38,48,-10,2,-3,-9,-6
Nashville Predators,2015/03/12  vs. SJS,SJS,1,54,34,20,14,0,6,10,36,21,15,12,0,3,9
Nashville Predators,2014/11/08  vs. STL,STL,1,46,50,-4,-8,2,2,-6,38,38,0,-7,2,5,-2
Nashville Predators,2014/11/13  vs. STL,STL,1,44,34,10,-5,0,15,8,29,26,3,-3,0,6,2
Nashville Predators,2014/12/04  vs. STL,STL,1,49,40,9,-3,-3,15,10,31,32,-1,-2,-9,10,2
Nashville Predators,2014/12/30  vs. STL,STL,1,61,39,22,20,3,-1,20,50,27,23,23,0,0,24
Nashville Predators,2015/01/29  vs. STL,STL,1,38,34,4,-2,1,5,-3,35,31,4,-2,1,5,-3
Nashville Predators,2015/02/10  vs. TBL,TBL,1,44,58,-14,-4,-10,0,-5,33,40,-7,1,-8,0,0
Nashville Predators,2015/03/26  vs. TBL,TBL,1,24,41,-17,-2,-15,0,-2,18,31,-13,-2,-11,0,-2
Nashville Predators,2014/11/18  vs. TOR,TOR,1,48,48,0,2,-2,0,1,36,34,2,1,1,0,-2
Nashville Predators,2015/02/03  vs. TOR,TOR,1,47,37,10,3,0,7,-3,33,28,5,2,-2,5,-3
Nashville Predators,2014/11/02  vs. VAN,VAN,1,48,42,6,-2,7,1,-1,34,31,3,0,3,0,0
Nashville Predators,2015/01/13  vs. VAN,VAN,1,40,51,-11,-3,-8,0,-2,30,39,-9,-2,-7,0,0
Nashville Predators,2015/03/31  vs. VAN,VAN,1,32,32,0,0,3,-3,-2,25,24,1,0,4,-3,-2
Nashville Predators,2014/10/17  vs. WPG,WPG,1,40,35,5,-1,6,0,4,30,25,5,-1,6,0,4
Nashville Predators,2014/11/04  vs. WPG,WPG,1,42,37,5,3,0,2,-2,29,26,3,1,0,2,-2
Nashville Predators,2014/11/15  vs. WPG,WPG,1,45,46,-1,-8,1,6,-2,37,32,5,-3,1,7,4
Nashville Predators,2015/02/12  vs. WPG,WPG,1,27,37,-10,-4,-6,0,-10,22,27,-5,-1,-4,0,-5
Nashville Predators,2015/03/07  vs. WPG,WPG,1,39,38,1,-2,0,3,0,27,28,-1,-3,0,2,-1
Nashville Predators,2015/01/16  vs. WSH,WSH,1,41,52,-11,-19,6,2,-15,24,41,-17,-18,2,-1,-18
Nashville Predators,2015/03/28  vs. WSH,WSH,1,47,47,0,3,-3,0,10,35,33,2,3,-1,0,9
New Jersey Devils,2015/01/16  vs. ANA,ANA,1,36,59,-23,-8,0,-15,-15,21,41,-20,-2,0,-18,-11
New Jersey Devils,2015/03/29  vs. ANA,ANA,1,36,35,1,0,0,1,3,30,27,3,3,0,0,4
New Jersey Devils,2015/02/23  vs. ARI,ARI,1,35,45,-10,-3,-7,0,-11,30,36,-6,-1,-5,0,-4
New Jersey Devils,2015/03/14  vs. ARI,ARI,1,42,56,-14,-6,-8,0,-4,31,39,-8,-3,-5,0,-1
New Jersey Devils,2014/11/10  vs. BOS,BOS,1,50,41,9,0,0,9,-3,35,31,4,-1,1,4,-5
New Jersey Devils,2015/01/08  vs. BOS,BOS,1,32,59,-27,-11,0,-16,-22,25,42,-17,-7,0,-10,-12
New Jersey Devils,2015/02/27  vs. BOS,BOS,1,38,48,-10,6,0,-16,-6,31,35,-4,6,0,-10,1
New Jersey Devils,2015/01/06  vs. BUF,BUF,1,45,35,10,-3,13,0,4,30,24,6,-2,8,0,3
New Jersey Devils,2015/02/17  vs. BUF,BUF,1,42,34,8,5,3,0,8,32,26,6,5,1,0,6
New Jersey Devils,2015/03/20  vs. BUF,BUF,1,45,47,-2,7,-9,0,7,31,34,-3,1,-4,0,2
New Jersey Devils,2014/12/08  vs. CAR,CAR,1,38,63,-25,3,-27,-1,2,26,43,-17,2,-15,-4,-2
New Jersey Devils,2014/12/23  vs. CAR,CAR,1,29,41,-12,3,-15,0,-5,21,32,-11,1,-12,0,-7
New Jersey Devils,2015/02/21  vs. CAR,CAR,1,24,39,-15,-5,-10,0,-5,22,33,-11,-2,-9,0,-2
New Jersey Devils,2015/03/28  vs. CAR,CAR,1,42,55,-13,-16,5,-2,-11,29,41,-12,-12,1,-1,-11
New Jersey Devils,2014/11/01  vs. CBJ,CBJ,1,34,24,10,-4,1,13,6,24,22,2,-3,1,4,-2
New Jersey Devils,2015/02/28  vs. CBJ,CBJ,1,36,42,-6,-6,0,0,3,22,32,-10,-4,-6,0,-1
New Jersey Devils,2015/03/06  vs. CBJ,CBJ,1,43,37,6,-3,0,9,-4,32,28,4,-2,0,6,-3
New Jersey Devils,2015/03/31  vs. CBJ,CBJ,1,25,39,-14,-8,-1,-5,-14,24,30,-6,-2,-1,-3,-7
New Jersey Devils,2014/11/22  vs. CGY,CGY,1,46,34,12,0,12,0,3,29,27,2,-1,3,0,-3
New Jersey Devils,2015/02/25  vs. CGY,CGY,1,28,41,-13,-7,1,-7,-6,21,32,-11,-4,-1,-6,-5
New Jersey Devils,2014/12/09  vs. CHI,CHI,1,33,53,-20,-16,-4,0,-16,26,41,-15,-11,-4,0,-12
New Jersey Devils,2015/02/13  vs. CHI,CHI,1,41,53,-12,4,-5,-11,-1,27,38,-11,4,-5,-10,-1
New Jersey Devils,2014/11/15  vs. COL,COL,1,36,32,4,-2,8,-2,2,29,29,0,-4,6,-2,-2
New Jersey Devils,2015/03/12  vs. COL,COL,1,51,46,5,9,0,-4,5,30,32,-2,0,0,-2,-2
New Jersey Devils,2014/10/24  vs. DAL,DAL,1,39,44,-5,-4,-2,1,-7,32,39,-7,-6,-2,1,-8
New Jersey Devils,2014/12/13  vs. DAL,DAL,1,58,67,-9,-3,0,-6,-3,46,49,-3,0,0,-3,0
New Jersey Devils,2014/11/07  vs. DET,DET,1,30,29,1,1,0,0,-3,17,26,-9,0,-1,-8,-9
New Jersey Devils,2014/11/28  vs. DET,DET,1,28,31,-3,-2,-1,0,-4,25,27,-2,0,-2,0,-3
New Jersey Devils,2014/12/31  vs. DET,DET,1,21,40,-19,-16,1,-4,-15,14,31,-17,-14,1,-4,-13
New Jersey Devils,2014/11/21  vs. EDM,EDM,1,31,52,-21,-15,-6,0,-14,26,34,-8,-9,1,0,-6
New Jersey Devils,2015/02/09  vs. EDM,EDM,1,31,33,-2,0,2,-4,1,23,26,-3,-4,3,-2,-1
New Jersey Devils,2014/10/11  vs. FLA,FLA,1,22,30,-8,0,-8,0,1,17,26,-9,-1,-8,0,-1
New Jersey Devils,2015/01/31  vs. FLA,FLA,1,27,41,-14,-2,-12,0,-2,18,30,-12,-2,-10,0,-2
New Jersey Devils,2015/04/11  vs. FLA,FLA,1,45,42,3,-1,4,0,3,37,29,8,2,5,1,7
New Jersey Devils,2015/01/14  vs. LAK,LAK,1,33,42,-9,-1,-8,0,0,25,30,-5,-5,0,0,-4
New Jersey Devils,2015/03/23  vs. LAK,LAK,1,36,43,-7,-6,0,-1,-4,26,35,-9,-5,0,-4,-6
New Jersey Devils,2014/11/11  vs. MIN,MIN,1,24,29,-5,-1,-4,0,2,21,24,-3,-1,-2,0,2
New Jersey Devils,2015/03/10  vs. MIN,MIN,1,44,61,-17,-5,0,-12,-7,40,49,-9,-4,0,-5,-6
New Jersey Devils,2015/01/02  vs. MTL,MTL,1,32,29,3,1,0,2,-3,26,26,0,-2,0,2,-4
New Jersey Devils,2015/02/07  vs. MTL,MTL,1,40,65,-25,-3,-14,-8,-23,29,48,-19,-1,-11,-7,-15
New Jersey Devils,2015/04/03  vs. MTL,MTL,1,28,28,0,1,-3,2,0,18,25,-7,-2,-3,-2,-7
New Jersey Devils,2015/02/14  vs. NSH,NSH,1,35,60,-25,-8,0,-17,-23,28,43,-15,-8,0,-7,-13
New Jersey Devils,2015/03/03  vs. NSH,NSH,1,37,51,-14,0,-14,0,-8,30,38,-8,0,-8,0,-4
New Jersey Devils,2014/11/29  vs. NYI,NYI,1,53,38,15,-6,0,21,-9,33,29,4,-3,0,7,-9
New Jersey Devils,2014/12/15  vs. NYI,NYI,1,36,44,-8,-3,-5,0,-5,26,31,-5,-4,-1,0,-6
New Jersey Devils,2015/01/09  vs. NYI,NYI,1,27,36,-9,-13,4,0,-9,24,27,-3,-6,3,0,-3
New Jersey Devils,2015/03/21  vs. NYI,NYI,1,47,40,7,3,0,4,2,36,33,3,3,0,0,-1
New Jersey Devils,2014/10/21  vs. NYR,NYR,1,34,31,3,10,-8,1,10,26,25,1,4,-5,2,6
New Jersey Devils,2014/12/27  vs. NYR,NYR,1,32,40,-8,1,0,-9,-5,24,27,-3,1,0,-4,-4
New Jersey Devils,2015/04/04  vs. NYR,NYR,1,56,45,11,3,0,8,6,38,37,1,4,0,-3,6
New Jersey Devils,2015/04/07  vs. NYR,NYR,1,35,37,-2,-6,0,4,-6,28,32,-4,-6,0,2,-6
New Jersey Devils,2014/10/25  vs. OTT,OTT,1,43,44,-1,-2,-2,3,1,32,30,2,2,-3,3,4
New Jersey Devils,2014/12/17  vs. OTT,OTT,1,40,18,22,1,0,21,15,29,14,15,1,0,14,11
New Jersey Devils,2015/02/03  vs. OTT,OTT,1,25,32,-7,-3,-3,-1,-4,24,23,1,3,-1,-1,2
New Jersey Devils,2014/10/09  vs. PHI,PHI,1,44,51,-7,-3,-4,0,-1,32,42,-10,-5,-5,0,-5
New Jersey Devils,2014/12/11  vs. PHI,PHI,1,40,34,6,-1,0,7,-1,22,26,-4,-1,0,-3,-4
New Jersey Devils,2015/01/03  vs. PHI,PHI,1,34,35,-1,7,-8,0,7,23,22,1,4,-3,0,4
New Jersey Devils,2015/03/08  vs. PHI,PHI,1,31,32,-1,-6,5,0,1,23,25,-2,-7,5,0,-1
New Jersey Devils,2014/10/28  vs. PIT,PIT,1,32,30,2,5,-5,2,-3,23,22,1,5,-5,1,-3
New Jersey Devils,2014/12/02  vs. PIT,PIT,1,48,34,14,10,0,4,10,36,24,12,11,0,1,11
New Jersey Devils,2014/12/29  vs. PIT,PIT,1,37,41,-4,2,3,-9,-4,29,30,-1,2,3,-6,-1
New Jersey Devils,2015/01/30  vs. PIT,PIT,1,19,49,-30,-22,-8,0,-22,16,38,-22,-16,-6,0,-16
New Jersey Devils,2015/03/17  vs. PIT,PIT,1,24,45,-21,-4,-17,0,-6,19,38,-19,-3,-16,0,-4
New Jersey Devils,2014/10/18  vs. SJS,SJS,1,41,32,9,-5,0,14,1,34,27,7,-3,0,10,1
New Jersey Devils,2015/01/19  vs. SJS,SJS,1,46,48,-2,5,-14,7,15,36,33,3,5,-9,7,15
New Jersey Devils,2014/11/04  vs. STL,STL,1,39,33,6,3,0,3,3,28,26,2,1,0,1,1
New Jersey Devils,2014/11/06  vs. STL,STL,1,42,41,1,-2,0,3,1,31,32,-1,-2,0,1,2
New Jersey Devils,2014/10/14  vs. TBL,TBL,1,32,37,-5,-3,-2,0,-2,26,27,-1,0,-1,0,-1
New Jersey Devils,2014/12/19  vs. TBL,TBL,1,14,38,-24,1,-25,0,-12,11,28,-17,1,-18,0,-8
New Jersey Devils,2015/04/09  vs. TBL,TBL,1,41,37,4,2,0,2,4,24,24,0,2,-1,-1,0
New Jersey Devils,2014/12/04  vs. TOR,TOR,1,38,47,-9,-4,-5,0,-5,31,36,-5,-1,-4,0,-6
New Jersey Devils,2015/01/28  vs. TOR,TOR,1,23,22,1,0,0,1,0,19,16,3,3,0,0,3
New Jersey Devils,2015/02/06  vs. TOR,TOR,1,25,43,-18,-3,-15,0,-5,23,37,-14,-2,-12,0,-3
New Jersey Devils,2014/11/25  vs. VAN,VAN,1,39,52,-13,-10,0,-3,-10,28,42,-14,-9,0,-5,-11
New Jersey Devils,2015/02/20  vs. VAN,VAN,1,34,31,3,4,-1,0,6,28,26,2,1,1,0,3
New Jersey Devils,2014/10/30  vs. WPG,WPG,1,44,28,16,5,0,11,10,32,24,8,4,0,4,5
New Jersey Devils,2014/11/18  vs. WPG,WPG,1,34,50,-16,-6,0,-10,-7,24,37,-13,-6,0,-7,-7
New Jersey Devils,2014/10/16  vs. WSH,WSH,1,45,35,10,5,0,5,9,31,26,5,4,0,1,5
New Jersey Devils,2014/11/14  vs. WSH,WSH,1,36,34,2,6,-4,0,6,24,27,-3,2,-5,0,2
New Jersey Devils,2014/12/06  vs. WSH,WSH,1,55,33,22,1,0,21,-2,41,31,10,-5,0,15,-10
New Jersey Devils,2014/12/20  vs. WSH,WSH,1,28,22,6,6,0,0,7,25,18,7,5,0,2,7
New Jersey Devils,2015/03/26  vs. WSH,WSH,1,34,38,-4,1,0,-5,-4,29,25,4,2,0,2,0
New York Islanders,2014/11/05  vs. ANA,ANA,1,56,56,0,1,-1,0,-8,40,41,-1,-4,3,0,-7
New York Islanders,2015/03/28  vs. ANA,ANA,1,59,48,11,2,0,9,2,40,34,6,1,0,5,0
New York Islanders,2014/11/08  vs. ARI,ARI,1,51,26,25,22,3,0,22,38,14,24,21,3,0,21
New York Islanders,2015/02/24  vs. ARI,ARI,1,59,61,-2,1,-3,0,-8,38,39,-1,-2,1,0,-5
New York Islanders,2014/10/23  vs. BOS,BOS,1,52,60,-8,2,-10,0,6,48,41,7,4,3,0,12
New York Islanders,2015/01/29  vs. BOS,BOS,1,64,53,11,-4,0,15,-8,51,39,12,0,0,12,-3
New York Islanders,2015/02/07  vs. BOS,BOS,1,53,48,5,6,-3,2,3,40,40,0,2,-2,0,0
New York Islanders,2014/12/27  vs. BUF,BUF,1,44,33,11,1,10,0,3,33,21,12,0,12,0,3
New York Islanders,2015/02/08  vs. BUF,BUF,1,58,24,34,14,20,0,27,38,17,21,7,14,0,19
New York Islanders,2015/04/04  vs. BUF,BUF,1,56,32,24,8,16,0,15,48,25,23,8,15,0,10
New York Islanders,2014/10/10  vs. CAR,CAR,1,43,38,5,3,2,0,3,33,28,5,3,2,0,3
New York Islanders,2014/10/11  vs. CAR,CAR,1,43,30,13,4,9,0,8,34,21,13,3,10,0,8
New York Islanders,2015/02/17  vs. CAR,CAR,1,55,73,-18,12,-30,0,6,41,52,-11,11,-22,0,6
New York Islanders,2015/02/28  vs. CAR,CAR,1,39,57,-18,-16,1,-3,-13,29,41,-12,-11,0,-1,-8
New York Islanders,2015/01/10  vs. CBJ,CBJ,1,46,33,13,9,4,0,14,40,22,18,12,6,0,18
New York Islanders,2015/02/14  vs. CBJ,CBJ,1,58,49,9,1,8,0,13,43,34,9,3,6,0,13
New York Islanders,2015/04/02  vs. CBJ,CBJ,1,40,49,-9,-2,-7,0,-2,32,36,-4,1,-5,0,1
New York Islanders,2015/04/11  vs. CBJ,CBJ,1,68,49,19,15,4,0,15,54,37,17,12,5,0,12
New York Islanders,2015/01/02  vs. CGY,CGY,1,56,32,24,10,14,0,19,33,22,11,6,5,0,7
New York Islanders,2015/02/27  vs. CGY,CGY,1,56,44,12,5,7,0,6,40,27,13,6,7,0,5
New York Islanders,2014/12/13  vs. CHI,CHI,1,58,43,15,6,8,1,5,46,26,20,14,7,-1,13
New York Islanders,2015/03/17  vs. CHI,CHI,1,55,50,5,-6,0,11,-8,43,39,4,-4,0,8,-9
New York Islanders,2014/10/30  vs. COL,COL,1,60,27,33,2,0,31,18,41,24,17,1,0,16,8
New York Islanders,2014/11/11  vs. COL,COL,1,46,34,12,2,10,0,0,38,20,18,2,16,0,0
New York Islanders,2014/10/25  vs. DAL,DAL,1,41,47,-6,-8,4,-2,-5,33,34,-1,-5,6,-2,-1
New York Islanders,2015/03/03  vs. DAL,DAL,1,53,65,-12,-12,-1,1,-10,37,45,-8,-8,0,0,-6
New York Islanders,2014/12/19  vs. DET,DET,1,36,37,-1,1,-4,2,1,29,26,3,1,1,1,2
New York Islanders,2015/01/31  vs. DET,DET,1,36,26,10,6,0,4,5,27,18,9,5,0,4,6
New York Islanders,2015/03/29  vs. DET,DET,1,40,37,3,4,0,-1,1,25,25,0,1,0,-1,-1
New York Islanders,2015/01/04  vs. EDM,EDM,1,52,49,3,-2,0,5,-11,40,28,12,1,0,11,3
New York Islanders,2015/02/10  vs. EDM,EDM,1,48,42,6,0,3,3,3,35,33,2,-4,3,3,-1
New York Islanders,2014/11/14  vs. FLA,FLA,1,57,43,14,3,5,6,12,36,32,4,-1,2,3,5
New York Islanders,2015/02/03  vs. FLA,FLA,1,58,49,9,5,-1,5,3,41,33,8,5,-1,4,3
New York Islanders,2015/03/07  vs. FLA,FLA,1,42,27,15,14,0,1,16,31,18,13,11,0,2,14
New York Islanders,2014/11/06  vs. LAK,LAK,1,38,40,-2,-1,0,-1,-2,30,30,0,4,0,-4,0
New York Islanders,2015/03/26  vs. LAK,LAK,1,43,59,-16,-22,3,3,-19,28,40,-12,-16,1,3,-15
New York Islanders,2014/12/09  vs. MIN,MIN,1,35,54,-19,1,-22,2,2,25,35,-10,5,-17,2,6
New York Islanders,2015/03/24  vs. MIN,MIN,1,66,56,10,18,-8,0,19,46,39,7,11,-4,0,12
New York Islanders,2014/12/23  vs. MTL,MTL,1,61,39,22,7,3,12,10,40,27,13,6,3,4,6
New York Islanders,2015/01/17  vs. MTL,MTL,1,51,50,1,1,0,0,13,32,37,-5,0,0,-5,8
New York Islanders,2015/03/14  vs. MTL,MTL,1,48,31,17,7,0,10,6,30,25,5,1,0,4,0
New York Islanders,2014/11/29  vs. NJD,NJD,1,38,53,-15,6,-21,0,9,29,33,-4,3,-7,0,9
New York Islanders,2014/12/15  vs. NJD,NJD,1,44,36,8,3,0,5,5,31,26,5,4,0,1,6
New York Islanders,2015/01/09  vs. NJD,NJD,1,36,27,9,13,0,-4,9,27,24,3,6,0,-3,3
New York Islanders,2015/03/21  vs. NJD,NJD,1,40,47,-7,-3,-4,0,-2,33,36,-3,-3,0,0,1
New York Islanders,2015/02/19  vs. NSH,NSH,1,55,49,6,0,6,0,-4,44,29,15,1,14,0,1
New York Islanders,2015/03/05  vs. NSH,NSH,1,48,65,-17,-12,-5,0,-8,34,51,-17,-10,-7,0,-11
New York Islanders,2014/10/14  vs. NYR,NYR,1,41,60,-19,2,0,-21,-19,34,42,-8,4,2,-14,-10
New York Islanders,2015/01/13  vs. NYR,NYR,1,68,61,7,10,-3,0,10,52,39,13,8,5,0,8
New York Islanders,2015/01/27  vs. NYR,NYR,1,49,68,-19,5,-24,0,3,41,46,-5,5,-10,0,4
New York Islanders,2015/02/16  vs. NYR,NYR,1,55,53,2,0,6,-4,8,46,39,7,1,9,-3,10
New York Islanders,2015/03/10  vs. NYR,NYR,1,49,49,0,3,-10,7,-7,38,28,10,8,-1,3,7
New York Islanders,2014/12/02  vs. OTT,OTT,1,48,44,4,-9,-1,14,5,33,31,2,-4,-1,7,3
New York Islanders,2014/12/04  vs. OTT,OTT,1,40,43,-3,-2,-1,0,1,28,27,1,0,1,0,3
New York Islanders,2015/03/13  vs. OTT,OTT,1,49,50,-1,-3,0,2,1,34,33,1,1,0,0,4
New York Islanders,2014/11/24  vs. PHI,PHI,1,65,29,36,36,0,0,36,54,22,32,32,0,0,32
New York Islanders,2015/01/19  vs. PHI,PHI,1,45,41,4,-2,6,0,5,36,30,6,-1,7,0,3
New York Islanders,2015/02/05  vs. PHI,PHI,1,58,43,15,6,0,9,17,40,25,15,9,0,6,17
New York Islanders,2015/04/07  vs. PHI,PHI,1,49,49,0,-5,0,5,-4,34,37,-3,-1,0,-2,0
New York Islanders,2014/10/18  vs. PIT,PIT,1,37,40,-3,-3,-5,5,-4,25,31,-6,-2,-5,1,-4
New York Islanders,2014/11/21  vs. PIT,PIT,1,60,50,10,8,1,1,-2,46,36,10,9,-1,2,3
New York Islanders,2014/11/22  vs. PIT,PIT,1,60,40,20,8,6,6,14,43,29,14,6,4,4,10
New York Islanders,2015/01/16  vs. PIT,PIT,1,53,41,12,10,-2,4,11,34,26,8,10,1,-3,7
New York Islanders,2015/04/10  vs. PIT,PIT,1,35,57,-22,-7,-15,0,-22,32,41,-9,-3,-6,0,-11
New York Islanders,2014/10/16  vs. SJS,SJS,1,66,49,17,11,2,4,13,51,25,26,19,2,5,23
New York Islanders,2014/11/01  vs. SJS,SJS,1,55,56,-1,-4,1,2,-3,31,39,-8,-10,1,1,-9
New York Islanders,2014/12/06  vs. STL,STL,1,39,50,-11,16,-18,-9,4,28,35,-7,9,-9,-7,1
New York Islanders,2014/12/11  vs. STL,STL,1,48,42,6,5,0,1,3,34,35,-1,2,0,-3,1
New York Islanders,2014/11/15  vs. TBL,TBL,1,36,40,-4,-3,-1,0,-7,27,32,-5,-1,-1,-3,-6
New York Islanders,2014/11/18  vs. TBL,TBL,1,38,42,-4,2,-8,2,6,30,27,3,3,-2,2,7
New York Islanders,2014/12/20  vs. TBL,TBL,1,63,42,21,12,4,5,12,49,28,21,14,5,2,14
New York Islanders,2014/10/21  vs. TOR,TOR,1,40,33,7,-6,4,9,-4,31,23,8,-5,5,8,-2
New York Islanders,2015/02/12  vs. TOR,TOR,1,56,49,7,-5,12,0,-3,41,39,2,-6,8,0,-7
New York Islanders,2015/03/09  vs. TOR,TOR,1,58,32,26,13,0,13,17,44,26,18,9,0,9,11
New York Islanders,2015/01/06  vs. VAN,VAN,1,47,36,11,-1,0,12,-3,25,24,1,-3,0,4,-6
New York Islanders,2015/02/22  vs. VAN,VAN,1,43,26,17,1,0,16,3,32,21,11,-1,0,12,0
New York Islanders,2014/10/28  vs. WPG,WPG,1,32,36,-4,-6,1,1,-4,27,27,0,-8,3,5,-3
New York Islanders,2014/12/31  vs. WPG,WPG,1,47,31,16,5,11,0,9,33,22,11,4,7,0,4
New York Islanders,2014/11/26  vs. WSH,WSH,1,57,38,19,18,1,0,19,41,32,9,10,-1,0,9
New York Islanders,2014/11/28  vs. WSH,WSH,1,55,63,-8,-6,0,-2,-9,39,37,2,-2,0,4,-2
New York Islanders,2014/12/29  vs. WSH,WSH,1,47,40,7,4,3,0,2,38,25,13,4,9,0,9
New York Islanders,2015/02/21  vs. WSH,WSH,1,61,58,3,-9,3,9,-6,40,33,7,0,2,5,2
New York Rangers,2015/01/07  vs. ANA,ANA,1,57,65,-8,0,-8,0,-4,43,46,-3,1,-4,0,-1
New York Rangers,2015/03/22  vs. ANA,ANA,1,45,65,-20,-7,-13,0,-7,34,53,-19,-6,-13,0,-10
New York Rangers,2015/02/14  vs. ARI,ARI,1,59,56,3,4,-1,0,2,44,48,-4,-1,-3,0,-3
New York Rangers,2015/02/26  vs. ARI,ARI,1,54,51,3,0,3,0,-4,41,47,-6,-4,2,-4,-11
New York Rangers,2015/01/15  vs. BOS,BOS,1,34,45,-11,-5,0,-6,-13,26,33,-7,-3,0,-4,-8
New York Rangers,2015/02/04  vs. BOS,BOS,1,49,37,12,5,9,-2,11,30,26,4,3,5,-4,5
New York Rangers,2015/03/28  vs. BOS,BOS,1,56,47,9,-3,0,12,-8,41,39,2,-2,0,4,-7
New York Rangers,2015/01/03  vs. BUF,BUF,1,58,29,29,6,23,0,6,40,21,19,4,15,0,4
New York Rangers,2015/02/20  vs. BUF,BUF,1,61,33,28,1,19,8,21,51,28,23,3,14,6,18
New York Rangers,2015/03/14  vs. BUF,BUF,1,57,20,37,26,11,0,26,44,17,27,20,7,0,20
New York Rangers,2014/10/16  vs. CAR,CAR,1,45,29,16,15,0,1,13,30,24,6,6,0,0,4
New York Rangers,2014/12/20  vs. CAR,CAR,1,61,32,29,7,0,22,19,46,25,21,7,0,14,12
New York Rangers,2014/12/21  vs. CAR,CAR,1,44,24,20,3,17,0,14,31,18,13,2,11,0,10
New York Rangers,2015/01/31  vs. CAR,CAR,1,53,52,1,-6,7,0,2,42,37,5,-3,8,0,3
New York Rangers,2015/03/21  vs. CAR,CAR,1,42,65,-23,-8,-9,-6,-11,33,42,-9,0,-4,-5,-1
New York Rangers,2014/10/11  vs. CBJ,CBJ,1,34,36,-2,-3,0,1,5,26,29,-3,-2,0,-1,4
New York Rangers,2015/01/16  vs. CBJ,CBJ,1,30,49,-19,-12,-7,0,-9,20,35,-15,-9,-6,0,-7
New York Rangers,2015/02/22  vs. CBJ,CBJ,1,41,41,0,-4,4,0,-7,32,31,1,-1,2,0,-4
New York Rangers,2015/04/06  vs. CBJ,CBJ,1,39,50,-11,-4,-9,2,-13,28,39,-11,-3,-11,3,-14
New York Rangers,2014/12/16  vs. CGY,CGY,1,30,45,-15,-2,-13,0,-2,22,28,-6,-1,-5,0,-1
New York Rangers,2015/02/24  vs. CGY,CGY,1,53,36,17,13,4,0,13,36,28,8,4,4,0,4
New York Rangers,2015/03/08  vs. CHI,CHI,1,42,51,-9,-9,0,0,-9,36,35,1,1,0,0,1
New York Rangers,2015/03/18  vs. CHI,CHI,1,42,47,-5,-6,0,1,-6,32,39,-7,-6,0,-1,-6
New York Rangers,2014/11/13  vs. COL,COL,1,44,39,5,6,3,-4,5,34,28,6,8,2,-4,6
New York Rangers,2015/02/12  vs. COL,COL,1,43,43,0,13,-13,0,18,27,34,-7,6,-13,0,9
New York Rangers,2014/12/29  vs. DAL,DAL,1,44,35,9,-2,-3,14,1,29,25,4,-1,-1,6,0
New York Rangers,2015/02/08  vs. DAL,DAL,1,57,37,20,3,0,17,3,42,27,15,2,0,13,1
New York Rangers,2014/11/05  vs. DET,DET,1,35,43,-8,4,-12,0,-4,27,31,-4,2,-6,0,-3
New York Rangers,2014/12/06  vs. DET,DET,1,30,47,-17,-12,-1,-4,-15,24,40,-16,-12,0,-4,-16
New York Rangers,2015/03/04  vs. DET,DET,1,52,39,13,15,0,-2,13,48,28,20,21,0,-1,20
New York Rangers,2014/11/09  vs. EDM,EDM,1,37,47,-10,-4,0,-6,-8,28,33,-5,2,0,-7,-6
New York Rangers,2014/12/14  vs. EDM,EDM,1,42,42,0,5,-5,0,7,33,25,8,2,6,0,10
New York Rangers,2014/12/31  vs. FLA,FLA,1,44,40,4,2,2,0,2,37,26,11,4,7,0,5
New York Rangers,2015/02/02  vs. FLA,FLA,1,47,59,-12,-4,-11,3,-11,41,45,-4,2,-9,3,-2
New York Rangers,2015/03/15  vs. FLA,FLA,1,43,88,-45,-6,-39,0,-30,38,57,-19,3,-22,0,-11
New York Rangers,2015/01/08  vs. LAK,LAK,1,39,45,-6,1,-5,-2,-2,28,36,-8,1,-4,-5,-3
New York Rangers,2015/03/24  vs. LAK,LAK,1,51,59,-8,-15,-6,13,-20,42,46,-4,-14,-2,12,-15
New York Rangers,2014/10/27  vs. MIN,MIN,1,27,31,-4,-1,3,-6,-2,22,26,-4,-2,3,-5,-3
New York Rangers,2015/04/02  vs. MIN,MIN,1,28,36,-8,-2,-6,0,-1,23,33,-10,-2,-8,0,-5
New York Rangers,2014/10/25  vs. MTL,MTL,1,54,47,7,-1,0,8,-2,41,35,6,-1,0,7,0
New York Rangers,2014/11/23  vs. MTL,MTL,1,50,39,11,4,7,0,1,35,30,5,1,4,0,-3
New York Rangers,2015/01/29  vs. MTL,MTL,1,36,41,-5,-6,0,1,-6,28,35,-7,-8,0,1,-8
New York Rangers,2014/10/21  vs. NJD,NJD,1,31,34,-3,-10,-1,8,-10,25,26,-1,-4,-2,5,-6
New York Rangers,2014/12/27  vs. NJD,NJD,1,40,32,8,-1,9,0,5,27,24,3,-1,4,0,4
New York Rangers,2015/04/04  vs. NJD,NJD,1,45,56,-11,-3,-8,0,-6,37,38,-1,-4,3,0,-6
New York Rangers,2015/04/07  vs. NJD,NJD,1,37,35,2,6,-4,0,6,32,28,4,6,-2,0,6
New York Rangers,2015/02/07  vs. NSH,NSH,1,49,47,2,-3,0,5,-3,38,36,2,-4,1,5,-3
New York Rangers,2015/03/02  vs. NSH,NSH,1,54,47,7,0,7,0,7,49,37,12,2,10,0,12
New York Rangers,2014/10/14  vs. NYI,NYI,1,60,41,19,-2,21,0,19,42,34,8,-4,14,-2,10
New York Rangers,2015/01/13  vs. NYI,NYI,1,61,68,-7,-10,0,3,-10,39,52,-13,-8,0,-5,-8
New York Rangers,2015/01/27  vs. NYI,NYI,1,68,49,19,-5,0,24,-3,46,41,5,-5,0,10,-4
New York Rangers,2015/02/16  vs. NYI,NYI,1,53,55,-2,0,4,-6,-8,39,46,-7,-1,3,-9,-10
New York Rangers,2015/03/10  vs. NYI,NYI,1,49,49,0,-3,-7,10,7,28,38,-10,-8,-3,1,-7
New York Rangers,2015/01/20  vs. OTT,OTT,1,49,53,-4,-8,5,-1,-2,39,37,2,-3,6,-1,4
New York Rangers,2015/03/26  vs. OTT,OTT,1,49,39,10,3,7,0,6,38,29,9,-1,10,0,2
New York Rangers,2015/04/09  vs. OTT,OTT,1,44,38,6,7,0,-1,5,28,34,-6,-2,0,-4,-4
New York Rangers,2014/11/19  vs. PHI,PHI,1,35,32,3,2,1,0,9,29,30,-1,2,-3,0,7
New York Rangers,2014/11/28  vs. PHI,PHI,1,36,39,-3,2,-5,0,-1,22,28,-6,0,-6,0,-5
New York Rangers,2014/11/29  vs. PHI,PHI,1,48,40,8,6,1,1,17,38,28,10,8,1,1,14
New York Rangers,2015/02/28  vs. PHI,PHI,1,59,54,5,-1,0,6,-1,40,38,2,-3,0,5,-3
New York Rangers,2014/11/11  vs. PIT,PIT,1,39,56,-17,-1,-16,0,-2,29,39,-10,0,-10,0,0
New York Rangers,2014/11/15  vs. PIT,PIT,1,33,54,-21,-17,-4,0,-21,26,40,-14,-11,-3,0,-14
New York Rangers,2014/12/08  vs. PIT,PIT,1,32,47,-15,-6,-7,-2,-6,25,36,-11,-7,-3,-1,-5
New York Rangers,2015/01/18  vs. PIT,PIT,1,34,46,-12,-1,-11,0,-3,22,35,-13,0,-13,0,-2
New York Rangers,2014/10/19  vs. SJS,SJS,1,48,42,6,11,-5,0,10,37,31,6,8,-2,0,6
New York Rangers,2015/01/10  vs. SJS,SJS,1,53,47,6,-6,12,0,-1,39,33,6,-3,9,0,1
New York Rangers,2014/10/09  vs. STL,STL,1,39,43,-4,-3,-1,0,-5,27,29,-2,-4,2,0,-4
New York Rangers,2014/11/03  vs. STL,STL,1,49,42,7,-7,7,7,-1,37,35,2,-5,5,2,0
New York Rangers,2014/11/17  vs. TBL,TBL,1,42,47,-5,1,0,-6,-1,24,35,-11,1,0,-12,-5
New York Rangers,2014/11/26  vs. TBL,TBL,1,33,44,-11,-2,-1,-8,-13,24,38,-14,-2,-1,-11,-13
New York Rangers,2014/12/01  vs. TBL,TBL,1,44,40,4,3,0,1,-2,29,26,3,5,-1,-1,2
New York Rangers,2014/10/12  vs. TOR,TOR,1,54,45,9,11,0,-2,4,44,35,9,9,0,0,8
New York Rangers,2014/11/08  vs. TOR,TOR,1,51,49,2,-6,0,8,1,37,37,0,-3,-4,7,-4
New York Rangers,2015/02/10  vs. TOR,TOR,1,57,53,4,-2,6,0,4,46,41,5,-2,7,0,5
New York Rangers,2014/12/13  vs. VAN,VAN,1,34,50,-16,-2,-14,0,-1,27,34,-7,0,-7,0,1
New York Rangers,2015/02/19  vs. VAN,VAN,1,40,41,-1,1,-2,0,8,32,30,2,2,0,0,8
New York Rangers,2014/11/01  vs. WPG,WPG,1,43,48,-5,-5,0,0,-5,33,32,1,1,0,0,1
New York Rangers,2015/03/31  vs. WPG,WPG,1,33,68,-35,-28,4,-11,-39,24,45,-21,-19,4,-6,-25
New York Rangers,2014/12/23  vs. WSH,WSH,1,23,42,-19,-1,-18,0,4,17,30,-13,0,-13,0,4
New York Rangers,2015/03/11  vs. WSH,WSH,1,34,52,-18,3,-21,0,6,27,36,-9,4,-13,0,5
New York Rangers,2015/03/29  vs. WSH,WSH,1,32,38,-6,-12,3,3,-6,26,30,-4,-8,1,3,-3
New York Rangers,2015/04/11  vs. WSH,WSH,1,32,48,-16,-2,-14,0,-2,26,33,-7,-2,-5,0,-2
Ottawa Senators,2014/12/19  vs. ANA,ANA,1,45,53,-8,-2,-6,0,-3,35,37,-2,-1,-1,0,-3
Ottawa Senators,2015/02/25  vs. ANA,ANA,1,42,41,1,-1,2,0,4,32,29,3,-2,5,0,3
Ottawa Senators,2015/01/10  vs. ARI,ARI,1,37,33,4,0,7,-3,7,27,27,0,-1,4,-3,1
Ottawa Senators,2015/01/31  vs. ARI,ARI,1,41,40,1,6,-5,0,7,31,29,2,3,-1,0,4
Ottawa Senators,2014/11/01  vs. BOS,BOS,1,39,56,-17,-14,0,-3,-15,31,42,-11,-6,0,-5,-8
Ottawa Senators,2014/12/13  vs. BOS,BOS,1,47,51,-4,1,0,-5,1,31,39,-8,-6,0,-2,-3
Ottawa Senators,2015/01/03  vs. BOS,BOS,1,32,43,-11,-12,0,1,-12,28,33,-5,-6,1,0,-5
Ottawa Senators,2015/03/10  vs. BOS,BOS,1,58,31,27,-2,0,29,8,39,24,15,-2,0,17,4
Ottawa Senators,2015/03/19  vs. BOS,BOS,1,52,39,13,-5,13,5,8,39,29,10,-2,9,3,7
Ottawa Senators,2014/12/15  vs. BUF,BUF,1,35,39,-4,-4,-2,2,4,24,36,-12,-7,-4,-1,-4
Ottawa Senators,2014/12/29  vs. BUF,BUF,1,64,24,40,21,8,11,31,44,21,23,13,3,7,17
Ottawa Senators,2015/02/10  vs. BUF,BUF,1,51,44,7,19,-12,0,5,34,39,-5,13,-18,0,-7
Ottawa Senators,2015/03/06  vs. BUF,BUF,1,72,42,30,2,-2,30,29,48,29,19,0,-2,21,17
Ottawa Senators,2015/01/17  vs. CAR,CAR,1,61,39,22,13,1,8,19,43,31,12,5,1,6,9
Ottawa Senators,2015/02/16  vs. CAR,CAR,1,61,44,17,7,0,10,9,44,35,9,2,0,7,2
Ottawa Senators,2015/03/17  vs. CAR,CAR,1,43,47,-4,-13,0,9,-4,32,39,-7,-15,0,8,-7
Ottawa Senators,2014/10/18  vs. CBJ,CBJ,1,46,52,-6,2,-8,0,-1,35,45,-10,-1,-9,0,-5
Ottawa Senators,2014/10/28  vs. CBJ,CBJ,1,43,43,0,-3,2,1,-2,34,35,-1,-8,6,1,-4
Ottawa Senators,2015/02/07  vs. CBJ,CBJ,1,52,48,4,-12,0,16,-12,40,37,3,-6,0,9,-6
Ottawa Senators,2014/11/15  vs. CGY,CGY,1,35,43,-8,-8,-5,5,-13,22,33,-11,-5,-7,1,-12
Ottawa Senators,2015/03/08  vs. CGY,CGY,1,61,53,8,3,5,0,7,44,40,4,0,4,0,6
Ottawa Senators,2014/10/26  vs. CHI,CHI,1,41,41,0,-9,0,9,-8,30,35,-5,-9,0,4,-12
Ottawa Senators,2014/10/30  vs. CHI,CHI,1,41,43,-2,-2,4,-4,-3,30,32,-2,-4,5,-3,-5
Ottawa Senators,2014/10/16  vs. COL,COL,1,36,35,1,2,-1,0,-1,24,26,-2,0,0,-2,-5
Ottawa Senators,2015/01/08  vs. COL,COL,1,57,24,33,5,0,28,9,38,22,16,4,0,12,6
Ottawa Senators,2015/01/13  vs. DAL,DAL,1,58,44,14,4,-3,13,6,40,33,7,2,-4,9,2
Ottawa Senators,2015/01/29  vs. DAL,DAL,1,43,46,-3,-7,0,4,-9,29,39,-10,-7,0,-3,-14
Ottawa Senators,2014/11/04  vs. DET,DET,1,37,49,-12,-4,-8,0,-11,27,38,-11,-1,-10,0,-8
Ottawa Senators,2014/11/24  vs. DET,DET,1,31,39,-8,1,-10,1,-13,20,34,-14,-1,-9,-4,-12
Ottawa Senators,2014/12/27  vs. DET,DET,1,40,34,6,8,-2,0,9,29,29,0,3,-3,0,3
Ottawa Senators,2015/03/31  vs. DET,DET,1,44,27,17,14,0,3,17,35,22,13,13,0,0,15
Ottawa Senators,2014/11/13  vs. EDM,EDM,1,32,35,-3,0,-3,0,5,27,32,-5,-2,-3,0,4
Ottawa Senators,2015/02/14  vs. EDM,EDM,1,57,40,17,3,14,0,5,47,30,17,3,14,0,5
Ottawa Senators,2014/10/13  vs. FLA,FLA,1,29,42,-13,-11,-2,0,-15,24,32,-8,-8,0,0,-12
Ottawa Senators,2014/11/28  vs. FLA,FLA,1,34,60,-26,-14,-13,1,-26,26,48,-22,-11,-11,0,-21
Ottawa Senators,2015/02/21  vs. FLA,FLA,1,41,28,13,13,2,-2,10,36,23,13,11,4,-2,9
Ottawa Senators,2015/03/29  vs. FLA,FLA,1,46,47,-1,-1,0,0,-2,27,34,-7,-5,0,-2,-8
Ottawa Senators,2014/12/11  vs. LAK,LAK,1,52,52,0,9,0,-9,6,34,39,-5,8,0,-13,6
Ottawa Senators,2015/02/26  vs. LAK,LAK,1,36,56,-20,-15,-5,0,-15,27,43,-16,-10,-6,0,-10
Ottawa Senators,2014/11/06  vs. MIN,MIN,1,23,42,-19,-7,-12,0,-10,16,32,-16,-5,-11,0,-7
Ottawa Senators,2015/03/03  vs. MIN,MIN,1,38,48,-10,-10,0,0,-9,25,37,-12,-12,0,0,-11
Ottawa Senators,2014/12/20  vs. MTL,MTL,1,47,46,1,5,-7,3,0,31,32,-1,6,-7,0,1
Ottawa Senators,2015/01/15  vs. MTL,MTL,1,48,39,9,5,4,0,7,36,25,11,3,8,0,7
Ottawa Senators,2015/02/18  vs. MTL,MTL,1,54,52,2,6,-4,0,8,40,44,-4,-1,-3,0,1
Ottawa Senators,2015/03/12  vs. MTL,MTL,1,51,42,9,3,9,-3,2,35,31,4,1,7,-4,0
Ottawa Senators,2014/10/25  vs. NJD,NJD,1,44,43,1,2,-3,2,-1,30,32,-2,-2,-3,3,-4
Ottawa Senators,2014/12/17  vs. NJD,NJD,1,18,40,-22,-1,-21,0,-15,14,29,-15,-1,-14,0,-11
Ottawa Senators,2015/02/03  vs. NJD,NJD,1,32,25,7,3,1,3,4,23,24,-1,-3,1,1,-2
Ottawa Senators,2014/10/09  vs. NSH,NSH,1,31,53,-22,-11,-10,-1,-21,25,45,-20,-8,-10,-2,-18
Ottawa Senators,2014/11/20  vs. NSH,NSH,1,40,45,-5,1,-8,2,8,28,38,-10,1,-12,1,5
Ottawa Senators,2014/12/02  vs. NYI,NYI,1,44,48,-4,9,-14,1,-5,31,33,-2,4,-7,1,-3
Ottawa Senators,2014/12/04  vs. NYI,NYI,1,43,40,3,2,0,1,-1,27,28,-1,0,0,-1,-3
Ottawa Senators,2015/03/13  vs. NYI,NYI,1,50,49,1,3,-2,0,-1,33,34,-1,-1,0,0,-4
Ottawa Senators,2015/01/20  vs. NYR,NYR,1,53,49,4,8,1,-5,2,37,39,-2,3,1,-6,-4
Ottawa Senators,2015/03/26  vs. NYR,NYR,1,39,49,-10,-3,0,-7,-6,29,38,-9,1,0,-10,-2
Ottawa Senators,2015/04/09  vs. NYR,NYR,1,38,44,-6,-7,1,0,-5,34,28,6,2,4,0,4
Ottawa Senators,2015/01/06  vs. PHI,PHI,1,58,47,11,9,2,0,9,44,37,7,6,1,0,6
Ottawa Senators,2015/03/15  vs. PHI,PHI,1,39,34,5,8,-3,0,5,27,21,6,8,-2,0,6
Ottawa Senators,2015/04/11  vs. PHI,PHI,1,40,46,-6,-1,-5,0,-7,26,37,-11,-4,-7,0,-12
Ottawa Senators,2014/12/06  vs. PIT,PIT,1,34,36,-2,-7,8,-3,-4,25,30,-5,-8,5,-2,-7
Ottawa Senators,2015/02/12  vs. PIT,PIT,1,38,39,-1,3,0,-4,-7,29,30,-1,3,0,-4,-4
Ottawa Senators,2015/04/07  vs. PIT,PIT,1,53,45,8,0,0,8,-2,40,35,5,0,0,5,-4
Ottawa Senators,2015/02/28  vs. SJS,SJS,1,45,51,-6,-2,-3,-1,-7,30,40,-10,-3,-2,-5,-10
Ottawa Senators,2015/03/23  vs. SJS,SJS,1,51,52,-1,2,0,-3,-6,41,36,5,2,5,-2,-1
Ottawa Senators,2014/11/22  vs. STL,STL,1,43,42,1,1,0,0,5,30,33,-3,0,0,-3,4
Ottawa Senators,2014/11/25  vs. STL,STL,1,45,22,23,5,0,18,12,25,17,8,2,0,6,3
Ottawa Senators,2014/10/11  vs. TBL,TBL,1,38,46,-8,9,2,-19,-7,28,39,-11,4,2,-17,-10
Ottawa Senators,2014/11/29  vs. TBL,TBL,1,41,49,-8,-3,-7,2,-10,33,34,-1,4,-7,2,-3
Ottawa Senators,2015/01/04  vs. TBL,TBL,1,24,43,-19,2,-18,-3,-14,13,28,-15,0,-9,-6,-10
Ottawa Senators,2015/04/02  vs. TBL,TBL,1,37,39,-2,0,-2,0,-2,27,29,-2,0,-2,0,-2
Ottawa Senators,2014/11/09  vs. TOR,TOR,1,52,33,19,3,5,11,6,38,31,7,0,0,7,-2
Ottawa Senators,2015/01/21  vs. TOR,TOR,1,42,51,-9,-3,-6,0,-1,31,41,-10,-3,-7,0,0
Ottawa Senators,2015/03/21  vs. TOR,TOR,1,39,37,2,-4,6,0,-14,31,28,3,-4,7,0,-13
Ottawa Senators,2015/03/28  vs. TOR,TOR,1,45,51,-6,1,-7,0,0,33,39,-6,0,-6,0,0
Ottawa Senators,2015/04/05  vs. TOR,TOR,1,66,45,21,18,0,3,21,50,35,15,14,0,1,15
Ottawa Senators,2014/11/11  vs. VAN,VAN,1,39,46,-7,-13,0,6,-9,27,36,-9,-13,0,4,-11
Ottawa Senators,2014/12/07  vs. VAN,VAN,1,49,43,6,6,0,0,5,33,32,1,5,0,-4,3
Ottawa Senators,2014/11/08  vs. WPG,WPG,1,56,45,11,19,-8,0,11,38,33,5,11,-6,0,5
Ottawa Senators,2015/03/04  vs. WPG,WPG,1,29,52,-23,-5,-18,0,-11,22,36,-14,-5,-9,0,-7
Ottawa Senators,2014/12/22  vs. WSH,WSH,1,45,45,0,-8,0,8,-6,31,29,2,-5,0,7,-3
Ottawa Senators,2015/02/05  vs. WSH,WSH,1,32,50,-18,-11,-1,-6,-15,23,33,-10,-1,0,-9,-4
Ottawa Senators,2015/04/04  vs. WSH,WSH,1,34,56,-22,-7,-15,0,0,26,44,-18,-4,-14,0,1
Philadelphia Flyers,2014/10/14  vs. ANA,ANA,1,57,34,23,7,0,16,4,36,27,9,4,0,5,-1
Philadelphia Flyers,2014/12/03  vs. ANA,ANA,1,32,48,-16,-11,-2,-3,-12,27,36,-9,-9,1,-1,-7
Philadelphia Flyers,2014/12/29  vs. ARI,ARI,1,55,36,19,16,0,3,20,42,28,14,14,0,0,16
Philadelphia Flyers,2015/01/27  vs. ARI,ARI,1,64,40,24,9,1,14,26,49,33,16,6,1,9,18
Philadelphia Flyers,2014/10/08  vs. BOS,BOS,1,34,50,-16,-6,0,-10,-12,21,37,-16,-8,0,-8,-11
Philadelphia Flyers,2015/01/10  vs. BOS,BOS,1,42,30,12,-1,0,13,3,30,21,9,-3,0,12,4
Philadelphia Flyers,2015/03/07  vs. BOS,BOS,1,45,47,-2,6,-1,-7,-1,38,29,9,10,0,-1,9
Philadelphia Flyers,2015/01/17  vs. BUF,BUF,1,52,31,21,5,13,3,12,38,27,11,1,9,1,4
Philadelphia Flyers,2015/02/15  vs. BUF,BUF,1,57,32,25,14,11,0,25,39,27,12,9,3,0,14
Philadelphia Flyers,2015/02/19  vs. BUF,BUF,1,53,35,18,16,0,2,18,36,29,7,4,0,3,7
Philadelphia Flyers,2014/12/13  vs. CAR,CAR,1,44,55,-11,1,-12,0,-1,32,35,-3,1,-4,0,-1
Philadelphia Flyers,2015/01/02  vs. CAR,CAR,1,40,42,-2,-7,0,5,-14,32,32,0,-5,0,5,-10
Philadelphia Flyers,2015/02/24  vs. CAR,CAR,1,44,52,-8,-2,0,-6,-13,30,36,-6,-1,0,-5,-8
Philadelphia Flyers,2015/04/04  vs. CAR,CAR,1,36,41,-5,-3,0,-2,-7,26,29,-3,-1,0,-2,-4
Philadelphia Flyers,2015/04/09  vs. CAR,CAR,1,37,36,1,0,0,1,4,28,26,2,0,0,2,3
Philadelphia Flyers,2014/11/14  vs. CBJ,CBJ,1,42,53,-11,-2,0,-9,-1,29,42,-13,-1,0,-12,-2
Philadelphia Flyers,2014/11/22  vs. CBJ,CBJ,1,46,33,13,5,8,0,12,36,24,12,3,9,0,9
Philadelphia Flyers,2014/12/09  vs. CBJ,CBJ,1,30,32,-2,-6,0,4,-12,22,19,3,-2,0,5,-4
Philadelphia Flyers,2015/02/13  vs. CBJ,CBJ,1,39,56,-17,1,-18,0,-12,27,38,-11,-1,-10,0,-9
Philadelphia Flyers,2015/02/17  vs. CBJ,CBJ,1,66,33,33,9,0,24,14,48,29,19,5,0,14,9
Philadelphia Flyers,2015/03/03  vs. CGY,CGY,1,74,45,29,14,0,15,16,47,35,12,6,0,6,7
Philadelphia Flyers,2015/03/19  vs. CGY,CGY,1,47,42,5,-1,0,6,-1,30,27,3,3,0,0,3
Philadelphia Flyers,2014/10/21  vs. CHI,CHI,1,46,52,-6,-6,0,0,-9,33,43,-10,-7,0,-3,-10
Philadelphia Flyers,2015/03/25  vs. CHI,CHI,1,55,59,-4,0,-4,0,-1,41,45,-4,-1,-3,0,-3
Philadelphia Flyers,2014/11/08  vs. COL,COL,1,34,47,-13,1,-14,0,1,23,36,-13,-2,-11,0,-2
Philadelphia Flyers,2014/12/31  vs. COL,COL,1,34,39,-5,-6,-2,3,-10,24,28,-4,-9,2,3,-7
Philadelphia Flyers,2014/10/18  vs. DAL,DAL,1,66,42,24,13,5,6,20,44,34,10,5,1,4,7
Philadelphia Flyers,2015/03/10  vs. DAL,DAL,1,38,53,-15,-12,-1,-2,-13,27,41,-14,-14,2,-2,-12
Philadelphia Flyers,2014/10/25  vs. DET,DET,1,21,63,-42,-10,-9,-23,-33,14,38,-24,-6,-5,-13,-19
Philadelphia Flyers,2014/11/26  vs. DET,DET,1,40,30,10,7,0,3,4,33,23,10,6,0,4,4
Philadelphia Flyers,2015/03/14  vs. DET,DET,1,51,48,3,3,0,0,4,36,34,2,0,2,0,0
Philadelphia Flyers,2014/11/04  vs. EDM,EDM,1,53,58,-5,-1,-4,0,8,35,40,-5,-2,-3,0,-1
Philadelphia Flyers,2015/03/21  vs. EDM,EDM,1,43,49,-6,6,-2,-10,-8,30,34,-4,2,0,-6,-6
Philadelphia Flyers,2014/11/01  vs. FLA,FLA,1,16,25,-9,0,0,-9,-12,13,23,-10,1,0,-11,-11
Philadelphia Flyers,2014/11/06  vs. FLA,FLA,1,45,45,0,1,-1,0,3,34,34,0,0,0,0,2
Philadelphia Flyers,2014/12/18  vs. FLA,FLA,1,41,53,-12,-17,0,5,-12,28,38,-10,-13,0,3,-10
Philadelphia Flyers,2014/10/28  vs. LAK,LAK,1,58,61,-3,-2,-1,0,-9,47,47,0,-2,2,0,-6
Philadelphia Flyers,2014/12/06  vs. LAK,LAK,1,20,43,-23,-2,-21,0,1,18,32,-14,0,-14,0,4
Philadelphia Flyers,2014/11/20  vs. MIN,MIN,1,46,31,15,15,0,0,14,30,25,5,10,0,-5,9
Philadelphia Flyers,2014/12/23  vs. MIN,MIN,1,41,35,6,7,-1,0,3,32,24,8,8,0,0,5
Philadelphia Flyers,2014/10/11  vs. MTL,MTL,1,42,79,-37,3,-40,0,4,25,50,-25,-2,-23,0,-1
Philadelphia Flyers,2014/11/15  vs. MTL,MTL,1,47,39,8,3,0,5,3,32,29,3,2,0,1,2
Philadelphia Flyers,2015/02/10  vs. MTL,MTL,1,37,66,-29,-4,-25,0,-21,25,49,-24,-3,-21,0,-15
Philadelphia Flyers,2014/10/09  vs. NJD,NJD,1,51,44,7,3,0,4,1,42,32,10,5,0,5,5
Philadelphia Flyers,2014/12/11  vs. NJD,NJD,1,34,40,-6,1,-7,0,1,26,22,4,1,3,0,4
Philadelphia Flyers,2015/01/03  vs. NJD,NJD,1,35,34,1,-7,0,8,-7,22,23,-1,-4,0,3,-4
Philadelphia Flyers,2015/03/08  vs. NJD,NJD,1,32,31,1,6,0,-5,-1,25,23,2,7,0,-5,1
Philadelphia Flyers,2014/12/27  vs. NSH,NSH,1,30,35,-5,-5,0,0,-9,23,25,-2,-1,0,-1,-6
Philadelphia Flyers,2015/02/21  vs. NSH,NSH,1,48,36,12,-3,15,0,12,36,24,12,-2,14,0,12
Philadelphia Flyers,2014/11/24  vs. NYI,NYI,1,29,65,-36,-36,0,0,-36,22,54,-32,-32,0,0,-32
Philadelphia Flyers,2015/01/19  vs. NYI,NYI,1,41,45,-4,2,0,-6,-5,30,36,-6,1,0,-7,-3
Philadelphia Flyers,2015/02/05  vs. NYI,NYI,1,43,58,-15,-6,-9,0,-17,25,40,-15,-9,-6,0,-17
Philadelphia Flyers,2015/04/07  vs. NYI,NYI,1,49,49,0,5,-5,0,4,37,34,3,1,2,0,0
Philadelphia Flyers,2014/11/19  vs. NYR,NYR,1,32,35,-3,-2,0,-1,-9,30,29,1,-2,0,3,-7
Philadelphia Flyers,2014/11/28  vs. NYR,NYR,1,39,36,3,-2,0,5,1,28,22,6,0,0,6,5
Philadelphia Flyers,2014/11/29  vs. NYR,NYR,1,40,48,-8,-6,-1,-1,-17,28,38,-10,-8,-1,-1,-14
Philadelphia Flyers,2015/02/28  vs. NYR,NYR,1,54,59,-5,1,-6,0,1,38,40,-2,3,-5,0,3
Philadelphia Flyers,2015/01/06  vs. OTT,OTT,1,47,58,-11,-9,0,-2,-9,37,44,-7,-6,0,-1,-6
Philadelphia Flyers,2015/03/15  vs. OTT,OTT,1,34,39,-5,-8,0,3,-5,21,27,-6,-8,0,2,-6
Philadelphia Flyers,2015/04/11  vs. OTT,OTT,1,46,40,6,1,0,5,7,37,26,11,4,0,7,12
Philadelphia Flyers,2014/10/22  vs. PIT,PIT,1,39,39,0,0,5,-5,0,33,31,2,3,5,-6,0
Philadelphia Flyers,2015/01/20  vs. PIT,PIT,1,38,37,1,-3,4,0,1,27,30,-3,-5,3,-1,-2
Philadelphia Flyers,2015/04/01  vs. PIT,PIT,1,31,37,-6,-2,-10,6,3,29,25,4,-1,-1,6,6
Philadelphia Flyers,2015/04/05  vs. PIT,PIT,1,40,66,-26,-4,-17,-5,-23,29,51,-22,-6,-11,-5,-21
Philadelphia Flyers,2014/12/02  vs. SJS,SJS,1,44,43,1,-5,7,-1,2,35,36,-1,-8,8,-1,0
Philadelphia Flyers,2015/03/28  vs. SJS,SJS,1,34,59,-25,-13,0,-12,-19,20,42,-22,-12,0,-10,-15
Philadelphia Flyers,2015/03/05  vs. STL,STL,1,56,48,8,8,1,-1,9,41,31,10,3,3,4,9
Philadelphia Flyers,2015/03/12  vs. STL,STL,1,41,52,-11,-11,0,0,-11,24,38,-14,-14,0,0,-14
Philadelphia Flyers,2014/10/30  vs. TBL,TBL,1,31,35,-4,-3,0,-1,-11,24,23,1,-1,0,2,-4
Philadelphia Flyers,2014/12/16  vs. TBL,TBL,1,43,32,11,7,1,3,7,30,28,2,-1,1,2,0
Philadelphia Flyers,2015/01/12  vs. TBL,TBL,1,36,45,-9,2,-11,0,13,24,37,-13,1,-14,0,8
Philadelphia Flyers,2014/12/20  vs. TOR,TOR,1,51,37,14,10,4,0,16,41,29,12,9,2,1,13
Philadelphia Flyers,2015/01/31  vs. TOR,TOR,1,35,53,-18,0,-18,0,-3,24,36,-12,1,-13,0,-5
Philadelphia Flyers,2015/02/26  vs. TOR,TOR,1,53,24,29,10,0,19,16,40,17,23,7,0,16,11
Philadelphia Flyers,2015/01/15  vs. VAN,VAN,1,55,43,12,9,0,3,7,35,32,3,7,0,-4,3
Philadelphia Flyers,2015/03/17  vs. VAN,VAN,1,46,46,0,7,-4,-3,3,33,41,-8,-2,-1,-5,-3
Philadelphia Flyers,2014/12/21  vs. WPG,WPG,1,38,35,3,0,-2,5,-5,24,27,-3,0,-3,0,-7
Philadelphia Flyers,2015/01/29  vs. WPG,WPG,1,32,43,-11,-8,-3,0,-4,25,34,-9,-7,-2,0,-5
Philadelphia Flyers,2015/01/08  vs. WSH,WSH,1,54,46,8,4,0,4,6,35,27,8,4,0,4,7
Philadelphia Flyers,2015/01/14  vs. WSH,WSH,1,40,45,-5,-2,0,-3,-7,24,32,-8,-1,0,-7,-7
Philadelphia Flyers,2015/02/08  vs. WSH,WSH,1,41,41,0,11,-11,0,8,29,25,4,8,-4,0,9
Philadelphia Flyers,2015/02/22  vs. WSH,WSH,1,40,36,4,10,-6,0,3,30,25,5,7,-2,0,4
Pittsburgh Penguins,2014/10/09  vs. ANA,ANA,1,47,34,13,2,11,0,3,38,26,12,1,11,0,2
Pittsburgh Penguins,2015/03/06  vs. ANA,ANA,1,30,39,-9,2,-11,0,4,23,29,-6,2,-8,0,3
Pittsburgh Penguins,2015/03/21  vs. ARI,ARI,1,44,42,2,3,9,-10,-2,37,31,6,3,10,-7,1
Pittsburgh Penguins,2015/03/28  vs. ARI,ARI,1,40,28,12,10,-2,4,10,36,18,18,15,-1,4,15
Pittsburgh Penguins,2014/11/24  vs. BOS,BOS,1,48,43,5,2,0,3,5,36,36,0,-1,-1,2,0
Pittsburgh Penguins,2015/01/07  vs. BOS,BOS,1,53,37,16,10,8,-2,16,42,28,14,12,5,-3,14
Pittsburgh Penguins,2015/03/14  vs. BOS,BOS,1,45,41,4,3,0,1,-2,36,29,7,4,0,3,3
Pittsburgh Penguins,2014/11/01  vs. BUF,BUF,1,49,30,19,5,14,0,10,35,16,19,3,16,0,9
Pittsburgh Penguins,2014/11/08  vs. BUF,BUF,1,42,32,10,2,8,0,6,40,22,18,2,16,0,6
Pittsburgh Penguins,2015/04/11  vs. BUF,BUF,1,65,35,30,14,16,0,24,51,25,26,13,13,0,19
Pittsburgh Penguins,2014/11/28  vs. CAR,CAR,1,33,52,-19,-14,0,-5,-20,25,38,-13,-9,0,-4,-14
Pittsburgh Penguins,2014/11/29  vs. CAR,CAR,1,38,38,0,2,-1,-1,-1,30,25,5,2,3,0,2
Pittsburgh Penguins,2014/12/31  vs. CAR,CAR,1,57,35,22,14,1,7,21,36,25,11,7,1,3,10
Pittsburgh Penguins,2015/03/26  vs. CAR,CAR,1,39,36,3,5,0,-2,-2,33,24,9,5,0,4,5
Pittsburgh Penguins,2014/12/13  vs. CBJ,CBJ,1,35,29,6,7,1,-2,5,24,19,5,3,0,2,5
Pittsburgh Penguins,2015/02/19  vs. CBJ,CBJ,1,44,34,10,11,0,-1,9,33,25,8,9,0,-1,8
Pittsburgh Penguins,2015/03/01  vs. CBJ,CBJ,1,46,29,17,7,9,1,8,32,20,12,8,4,0,8
Pittsburgh Penguins,2015/04/04  vs. CBJ,CBJ,1,37,45,-8,-10,2,0,-8,32,36,-4,-8,4,0,-5
Pittsburgh Penguins,2014/12/12  vs. CGY,CGY,1,33,25,8,1,7,0,11,26,22,4,0,4,0,9
Pittsburgh Penguins,2015/02/06  vs. CGY,CGY,1,46,29,17,7,10,0,6,40,21,19,6,13,0,7
Pittsburgh Penguins,2015/01/21  vs. CHI,CHI,1,48,43,5,6,0,-1,4,38,33,5,3,0,2,5
Pittsburgh Penguins,2015/02/15  vs. CHI,CHI,1,47,46,1,0,0,1,3,36,37,-1,2,0,-3,1
Pittsburgh Penguins,2014/12/18  vs. COL,COL,1,58,43,15,15,0,0,15,46,35,11,11,0,0,11
Pittsburgh Penguins,2015/03/04  vs. COL,COL,1,61,30,31,-1,0,32,6,39,19,20,-2,0,22,6
Pittsburgh Penguins,2014/10/16  vs. DAL,DAL,1,48,47,1,-1,2,0,-1,32,33,-1,0,-1,0,3
Pittsburgh Penguins,2015/03/19  vs. DAL,DAL,1,46,42,4,-11,0,15,-5,31,30,1,-10,0,11,-6
Pittsburgh Penguins,2014/10/23  vs. DET,DET,1,30,31,-1,-1,0,0,-7,22,27,-5,-2,-3,0,-7
Pittsburgh Penguins,2015/02/11  vs. DET,DET,1,34,47,-13,2,-15,0,3,26,35,-9,1,-10,0,3
Pittsburgh Penguins,2015/03/15  vs. DET,DET,1,49,31,18,2,0,16,0,34,20,14,1,0,13,4
Pittsburgh Penguins,2015/02/04  vs. EDM,EDM,1,55,30,25,14,11,0,32,39,23,16,8,8,0,21
Pittsburgh Penguins,2015/03/12  vs. EDM,EDM,1,47,48,-1,3,-4,0,4,38,37,1,4,-3,0,4
Pittsburgh Penguins,2014/12/20  vs. FLA,FLA,1,27,54,-27,-4,-23,0,-16,21,40,-19,-3,-16,0,-14
Pittsburgh Penguins,2014/12/22  vs. FLA,FLA,1,38,45,-7,-3,5,-9,2,27,34,-7,-4,5,-8,1
Pittsburgh Penguins,2015/02/22  vs. FLA,FLA,1,31,44,-13,-4,-9,0,-14,22,34,-12,-4,-8,0,-13
Pittsburgh Penguins,2014/10/30  vs. LAK,LAK,1,25,42,-17,1,-18,0,1,20,29,-9,1,-10,0,1
Pittsburgh Penguins,2015/03/07  vs. LAK,LAK,1,29,34,-5,-5,0,0,-5,22,27,-5,-5,0,0,-5
Pittsburgh Penguins,2014/11/04  vs. MIN,MIN,1,37,44,-7,2,-9,0,3,27,31,-4,-1,-3,0,0
Pittsburgh Penguins,2015/01/13  vs. MIN,MIN,1,55,55,0,-4,4,0,-1,38,41,-3,-2,-1,0,-1
Pittsburgh Penguins,2014/11/18  vs. MTL,MTL,1,44,52,-8,-1,-7,0,0,28,30,-2,2,-4,0,2
Pittsburgh Penguins,2015/01/03  vs. MTL,MTL,1,59,36,23,0,0,23,8,43,30,13,0,0,13,5
Pittsburgh Penguins,2015/01/10  vs. MTL,MTL,1,46,38,8,5,0,3,8,31,27,4,1,0,3,4
Pittsburgh Penguins,2014/10/28  vs. NJD,NJD,1,30,32,-2,-5,-2,5,3,22,23,-1,-5,-1,5,3
Pittsburgh Penguins,2014/12/02  vs. NJD,NJD,1,34,48,-14,-10,-4,0,-10,24,36,-12,-11,-1,0,-11
Pittsburgh Penguins,2014/12/29  vs. NJD,NJD,1,41,37,4,-2,9,-3,4,30,29,1,-2,6,-3,1
Pittsburgh Penguins,2015/01/30  vs. NJD,NJD,1,49,19,30,22,0,8,22,38,16,22,16,0,6,16
Pittsburgh Penguins,2015/03/17  vs. NJD,NJD,1,45,24,21,4,0,17,6,38,19,19,3,0,16,4
Pittsburgh Penguins,2014/10/25  vs. NSH,NSH,1,31,42,-11,-5,-6,0,5,24,27,-3,-4,1,0,9
Pittsburgh Penguins,2015/02/01  vs. NSH,NSH,1,36,33,3,-2,0,5,-2,21,25,-4,-1,0,-3,-1
Pittsburgh Penguins,2014/10/18  vs. NYI,NYI,1,40,37,3,3,-5,5,4,31,25,6,2,-1,5,4
Pittsburgh Penguins,2014/11/21  vs. NYI,NYI,1,50,60,-10,-8,-1,-1,2,36,46,-10,-9,-2,1,-3
Pittsburgh Penguins,2014/11/22  vs. NYI,NYI,1,40,60,-20,-8,-6,-6,-14,29,43,-14,-6,-4,-4,-10
Pittsburgh Penguins,2015/01/16  vs. NYI,NYI,1,41,53,-12,-10,-4,2,-11,26,34,-8,-10,3,-1,-7
Pittsburgh Penguins,2015/04/10  vs. NYI,NYI,1,57,35,22,7,0,15,22,41,32,9,3,0,6,11
Pittsburgh Penguins,2014/11/11  vs. NYR,NYR,1,56,39,17,1,0,16,2,39,29,10,0,0,10,0
Pittsburgh Penguins,2014/11/15  vs. NYR,NYR,1,54,33,21,17,0,4,21,40,26,14,11,0,3,14
Pittsburgh Penguins,2014/12/08  vs. NYR,NYR,1,47,32,15,6,2,7,6,36,25,11,7,1,3,5
Pittsburgh Penguins,2015/01/18  vs. NYR,NYR,1,46,34,12,1,0,11,3,35,22,13,0,0,13,2
Pittsburgh Penguins,2014/12/06  vs. OTT,OTT,1,36,34,2,7,3,-8,4,30,25,5,8,2,-5,7
Pittsburgh Penguins,2015/02/12  vs. OTT,OTT,1,39,38,1,-3,4,0,7,30,29,1,-3,4,0,4
Pittsburgh Penguins,2015/04/07  vs. OTT,OTT,1,45,53,-8,0,-8,0,2,35,40,-5,0,-5,0,4
Pittsburgh Penguins,2014/10/22  vs. PHI,PHI,1,39,39,0,0,5,-5,0,31,33,-2,-3,6,-5,0
Pittsburgh Penguins,2015/01/20  vs. PHI,PHI,1,37,38,-1,3,0,-4,-1,30,27,3,5,1,-3,2
Pittsburgh Penguins,2015/04/01  vs. PHI,PHI,1,37,31,6,2,-6,10,-3,25,29,-4,1,-6,1,-6
Pittsburgh Penguins,2015/04/05  vs. PHI,PHI,1,66,40,26,4,5,17,23,51,29,22,6,5,11,21
Pittsburgh Penguins,2015/03/09  vs. SJS,SJS,1,70,38,32,27,0,5,27,49,30,19,20,0,-1,18
Pittsburgh Penguins,2015/03/29  vs. SJS,SJS,1,47,51,-4,10,-14,0,10,36,36,0,7,-7,0,9
Pittsburgh Penguins,2015/02/21  vs. STL,STL,1,43,40,3,0,3,0,4,32,30,2,-1,3,0,2
Pittsburgh Penguins,2015/03/24  vs. STL,STL,1,43,48,-5,-1,-4,0,-4,33,35,-2,0,-2,0,-2
Pittsburgh Penguins,2014/12/15  vs. TBL,TBL,1,39,47,-8,-6,-2,0,-3,30,29,1,-6,7,0,2
Pittsburgh Penguins,2014/12/23  vs. TBL,TBL,1,43,42,1,1,0,0,1,28,33,-5,3,0,-8,1
Pittsburgh Penguins,2015/01/02  vs. TBL,TBL,1,49,45,4,0,4,0,3,32,32,0,0,0,0,2
Pittsburgh Penguins,2014/10/11  vs. TOR,TOR,1,52,32,20,1,19,0,2,37,24,13,-1,14,0,0
Pittsburgh Penguins,2014/11/14  vs. TOR,TOR,1,68,37,31,25,6,0,26,52,28,24,17,7,0,17
Pittsburgh Penguins,2014/11/26  vs. TOR,TOR,1,42,33,9,2,7,0,7,24,23,1,0,1,0,3
Pittsburgh Penguins,2014/12/04  vs. VAN,VAN,1,33,45,-12,1,0,-13,-17,23,35,-12,2,0,-14,-13
Pittsburgh Penguins,2015/02/07  vs. VAN,VAN,1,45,33,12,-2,0,14,0,33,27,6,-2,0,8,0
Pittsburgh Penguins,2014/11/06  vs. WPG,WPG,1,42,39,3,-2,5,0,3,29,29,0,-6,6,0,-2
Pittsburgh Penguins,2015/01/27  vs. WPG,WPG,1,41,40,1,-5,4,2,1,28,28,0,0,1,-1,-1
Pittsburgh Penguins,2014/12/27  vs. WSH,WSH,1,36,44,-8,-6,0,-2,-9,28,35,-7,-5,0,-2,-9
Pittsburgh Penguins,2015/01/28  vs. WSH,WSH,1,48,43,5,1,0,4,10,28,31,-3,1,0,-4,-1
Pittsburgh Penguins,2015/02/17  vs. WSH,WSH,1,38,39,-1,-1,0,0,0,28,33,-5,-4,0,-1,-4
Pittsburgh Penguins,2015/02/25  vs. WSH,WSH,1,35,31,4,13,-9,0,12,25,22,3,8,-5,0,7
San Jose Sharks,2014/10/26  vs. ANA,ANA,1,43,41,2,8,-6,0,12,32,28,4,2,2,0,6
San Jose Sharks,2014/11/29  vs. ANA,ANA,1,41,33,8,9,-1,0,16,34,25,9,7,2,0,13
San Jose Sharks,2014/12/22  vs. ANA,ANA,1,54,45,9,15,-9,3,19,41,36,5,11,-8,2,13
San Jose Sharks,2014/12/31  vs. ANA,ANA,1,30,45,-15,4,-19,0,2,22,35,-13,2,-15,0,-1
San Jose Sharks,2015/01/29  vs. ANA,ANA,1,45,52,-7,-11,6,-2,-16,27,32,-5,-9,5,-1,-12
San Jose Sharks,2014/11/22  vs. ARI,ARI,1,67,35,32,14,0,18,26,43,19,24,9,0,15,19
San Jose Sharks,2015/01/13  vs. ARI,ARI,1,48,41,7,6,4,-3,4,31,32,-1,0,1,-2,-3
San Jose Sharks,2015/02/13  vs. ARI,ARI,1,33,58,-25,-10,-6,-9,-19,25,44,-19,-9,-2,-8,-17
San Jose Sharks,2015/04/03  vs. ARI,ARI,1,62,38,24,-1,25,0,13,46,24,22,0,22,0,10
San Jose Sharks,2015/04/04  vs. ARI,ARI,1,57,45,12,1,0,11,3,43,33,10,4,0,6,3
San Jose Sharks,2014/10/21  vs. BOS,BOS,1,44,55,-11,-10,3,-4,-14,32,39,-7,-5,2,-4,-8
San Jose Sharks,2014/12/04  vs. BOS,BOS,1,57,40,17,11,3,3,14,42,30,12,9,3,0,12
San Jose Sharks,2014/10/25  vs. BUF,BUF,1,63,32,31,11,0,20,11,36,21,15,7,0,8,7
San Jose Sharks,2014/11/18  vs. BUF,BUF,1,42,21,21,8,0,13,15,27,15,12,5,0,7,11
San Jose Sharks,2014/11/16  vs. CAR,CAR,1,36,80,-44,-19,-25,0,-27,22,62,-40,-17,-23,0,-24
San Jose Sharks,2015/02/07  vs. CAR,CAR,1,43,48,-5,-5,0,0,-10,36,36,0,-2,0,2,-5
San Jose Sharks,2014/10/23  vs. CBJ,CBJ,1,39,35,4,1,3,0,6,33,24,9,4,6,-1,10
San Jose Sharks,2014/11/15  vs. CBJ,CBJ,1,59,26,33,7,0,26,27,44,22,22,3,0,19,20
San Jose Sharks,2014/11/26  vs. CGY,CGY,1,61,36,25,10,0,15,8,34,23,11,1,0,10,2
San Jose Sharks,2014/12/06  vs. CGY,CGY,1,51,63,-12,-9,-6,3,-15,40,46,-6,-9,-1,4,-9
San Jose Sharks,2015/01/17  vs. CGY,CGY,1,47,49,-2,-3,-3,4,-5,28,28,0,1,-1,0,-2
San Jose Sharks,2015/02/04  vs. CGY,CGY,1,46,32,14,5,0,9,8,35,26,9,4,0,5,7
San Jose Sharks,2015/02/09  vs. CGY,CGY,1,54,39,15,0,0,15,3,38,29,9,1,0,8,2
San Jose Sharks,2014/11/09  vs. CHI,CHI,1,44,47,-3,3,0,-6,2,32,38,-6,-2,0,-4,-1
San Jose Sharks,2015/01/31  vs. CHI,CHI,1,36,37,-1,3,-4,0,-4,25,26,-1,1,-2,0,-4
San Jose Sharks,2015/03/14  vs. CHI,CHI,1,49,40,9,18,0,-9,16,37,27,10,17,0,-7,15
San Jose Sharks,2014/10/28  vs. COL,COL,1,63,35,28,6,23,-1,29,50,30,20,0,21,-1,21
San Jose Sharks,2015/04/01  vs. COL,COL,1,61,30,31,13,18,0,17,33,20,13,4,9,0,6
San Jose Sharks,2014/11/08  vs. DAL,DAL,1,57,60,-3,2,-9,4,6,35,44,-9,4,-8,-5,1
San Jose Sharks,2015/02/19  vs. DAL,DAL,1,48,68,-20,2,-22,0,-1,35,48,-13,2,-15,0,0
San Jose Sharks,2015/04/06  vs. DAL,DAL,1,40,40,0,-2,0,2,-4,28,22,6,-1,0,7,1
San Jose Sharks,2015/02/26  vs. DET,DET,1,30,54,-24,9,-32,-1,-14,18,40,-22,5,-26,-1,-14
San Jose Sharks,2015/03/26  vs. DET,DET,1,36,54,-18,4,-22,0,-7,30,39,-9,3,-12,0,-4
San Jose Sharks,2014/12/07  vs. EDM,EDM,1,31,36,-5,-13,0,8,-9,24,22,2,-4,0,6,-1
San Jose Sharks,2014/12/09  vs. EDM,EDM,1,46,55,-9,-4,-5,0,-5,30,36,-6,-6,0,0,-6
San Jose Sharks,2014/12/18  vs. EDM,EDM,1,48,47,1,-3,2,2,-3,33,34,-1,-2,2,-1,-3
San Jose Sharks,2015/02/02  vs. EDM,EDM,1,64,61,3,-5,1,7,0,54,49,5,-6,2,9,0
San Jose Sharks,2015/04/09  vs. EDM,EDM,1,85,47,38,24,1,13,31,63,34,29,16,1,12,21
San Jose Sharks,2014/11/11  vs. FLA,FLA,1,49,36,13,1,0,12,0,36,31,5,2,0,3,1
San Jose Sharks,2014/11/20  vs. FLA,FLA,1,54,39,15,7,0,8,19,33,24,9,6,0,3,14
San Jose Sharks,2014/10/08  vs. LAK,LAK,1,45,56,-11,5,-16,0,-6,34,43,-9,2,-11,0,-7
San Jose Sharks,2014/12/27  vs. LAK,LAK,1,29,47,-18,-3,-9,-6,-15,19,32,-13,-6,-6,-1,-13
San Jose Sharks,2015/01/21  vs. LAK,LAK,1,43,31,12,9,3,0,18,30,24,6,2,4,0,9
San Jose Sharks,2015/02/21  vs. LAK,LAK,1,45,55,-10,-2,0,-8,-5,33,44,-11,1,0,-12,-2
San Jose Sharks,2015/04/11  vs. LAK,LAK,1,24,51,-27,-3,-19,-5,-22,22,38,-16,0,-10,-6,-10
San Jose Sharks,2014/10/30  vs. MIN,MIN,1,41,64,-23,-7,-16,0,-21,25,52,-27,-8,-19,0,-24
San Jose Sharks,2014/12/11  vs. MIN,MIN,1,55,40,15,15,0,0,21,41,25,16,13,3,0,18
San Jose Sharks,2015/01/06  vs. MIN,MIN,1,40,37,3,9,1,-7,8,31,28,3,10,0,-7,8
San Jose Sharks,2015/03/02  vs. MTL,MTL,1,67,47,20,3,17,0,8,46,30,16,2,14,0,3
San Jose Sharks,2015/03/21  vs. MTL,MTL,1,58,51,7,1,0,6,-3,38,33,5,-2,0,7,-3
San Jose Sharks,2014/10/18  vs. NJD,NJD,1,32,41,-9,5,-14,0,-1,27,34,-7,3,-10,0,-1
San Jose Sharks,2015/01/19  vs. NJD,NJD,1,48,46,2,-5,-7,14,-15,33,36,-3,-5,-7,9,-15
San Jose Sharks,2014/12/13  vs. NSH,NSH,1,52,51,1,3,-2,0,18,40,32,8,4,4,0,20
San Jose Sharks,2015/02/17  vs. NSH,NSH,1,60,50,10,-2,7,5,5,48,38,10,-2,9,3,6
San Jose Sharks,2015/03/12  vs. NSH,NSH,1,34,54,-20,-14,-6,0,-10,21,36,-15,-12,-3,0,-9
San Jose Sharks,2014/10/16  vs. NYI,NYI,1,49,66,-17,-11,-4,-2,-13,25,51,-26,-19,-5,-2,-23
San Jose Sharks,2014/11/01  vs. NYI,NYI,1,56,55,1,4,-2,-1,3,39,31,8,10,-1,-1,9
San Jose Sharks,2014/10/19  vs. NYR,NYR,1,42,48,-6,-11,0,5,-10,31,37,-6,-8,0,2,-6
San Jose Sharks,2015/01/10  vs. NYR,NYR,1,47,53,-6,6,0,-12,1,33,39,-6,3,0,-9,-1
San Jose Sharks,2015/02/28  vs. OTT,OTT,1,51,45,6,2,1,3,7,40,30,10,3,5,2,10
San Jose Sharks,2015/03/23  vs. OTT,OTT,1,52,51,1,-2,3,0,6,36,41,-5,-2,2,-5,1
San Jose Sharks,2014/12/02  vs. PHI,PHI,1,43,44,-1,5,1,-7,-2,36,35,1,8,1,-8,0
San Jose Sharks,2015/03/28  vs. PHI,PHI,1,59,34,25,13,12,0,19,42,20,22,12,10,0,15
San Jose Sharks,2015/03/09  vs. PIT,PIT,1,38,70,-32,-27,-5,0,-27,30,49,-19,-20,1,0,-18
San Jose Sharks,2015/03/29  vs. PIT,PIT,1,51,47,4,-10,0,14,-10,36,36,0,-7,0,7,-9
San Jose Sharks,2014/12/20  vs. STL,STL,1,51,46,5,-7,2,10,-6,34,33,1,-9,2,8,-8
San Jose Sharks,2015/01/03  vs. STL,STL,1,33,53,-20,-14,2,-8,-17,17,38,-21,-13,2,-10,-15
San Jose Sharks,2015/01/08  vs. STL,STL,1,34,46,-12,-4,0,-8,-6,28,39,-11,-4,0,-7,-5
San Jose Sharks,2014/11/13  vs. TBL,TBL,1,53,42,11,7,4,0,9,38,33,5,5,0,0,5
San Jose Sharks,2015/02/15  vs. TBL,TBL,1,48,47,1,1,0,0,8,40,40,0,0,0,0,6
San Jose Sharks,2015/01/15  vs. TOR,TOR,1,61,49,12,7,5,0,14,42,32,10,3,7,0,12
San Jose Sharks,2015/03/19  vs. TOR,TOR,1,55,36,19,8,11,0,12,43,27,16,8,8,0,8
San Jose Sharks,2014/11/06  vs. VAN,VAN,1,65,20,45,28,1,16,32,44,18,26,18,1,7,19
San Jose Sharks,2014/12/30  vs. VAN,VAN,1,50,45,5,0,0,5,-5,38,33,5,-1,0,6,-4
San Jose Sharks,2015/02/05  vs. VAN,VAN,1,51,47,4,6,-2,0,10,41,36,5,5,0,0,9
San Jose Sharks,2015/03/03  vs. VAN,VAN,1,37,48,-11,-3,-8,0,-1,28,36,-8,-2,-6,0,-1
San Jose Sharks,2015/03/07  vs. VAN,VAN,1,56,47,9,4,0,5,6,44,33,11,2,6,3,8
San Jose Sharks,2014/10/11  vs. WPG,WPG,1,34,40,-6,2,-8,0,4,27,28,-1,0,-1,0,2
San Jose Sharks,2015/01/05  vs. WPG,WPG,1,42,35,7,4,3,0,7,32,24,8,6,2,0,8
San Jose Sharks,2015/03/17  vs. WPG,WPG,1,59,39,20,-1,0,21,-1,43,28,15,0,0,15,-2
San Jose Sharks,2014/10/14  vs. WSH,WSH,1,37,55,-18,1,-19,0,-1,22,36,-14,-1,-13,0,-2
San Jose Sharks,2015/02/11  vs. WSH,WSH,1,57,46,11,4,12,-5,7,44,35,9,5,8,-4,5
St. Louis Blues,2014/10/19  vs. ANA,ANA,1,46,39,7,-1,0,8,-4,34,30,4,-1,0,5,-4
St. Louis Blues,2014/10/30  vs. ANA,ANA,1,46,36,10,-2,12,0,0,37,27,10,0,10,0,1
St. Louis Blues,2015/01/02  vs. ANA,ANA,1,41,41,0,-2,0,2,-4,34,30,4,2,0,2,0
St. Louis Blues,2014/10/18  vs. ARI,ARI,1,56,37,19,11,8,0,12,44,25,19,8,11,0,12
St. Louis Blues,2015/01/06  vs. ARI,ARI,1,48,43,5,8,-3,0,13,43,31,12,7,5,0,14
St. Louis Blues,2015/02/10  vs. ARI,ARI,1,47,39,8,1,1,6,10,37,28,9,3,2,4,12
St. Louis Blues,2014/11/18  vs. BOS,BOS,1,47,35,12,-2,0,14,1,37,23,14,0,0,14,5
St. Louis Blues,2015/02/20  vs. BOS,BOS,1,28,39,-11,-7,-6,2,-5,22,25,-3,-5,0,2,-3
St. Louis Blues,2014/11/11  vs. BUF,BUF,1,39,37,2,-6,8,0,-3,25,28,-3,-6,3,0,-6
St. Louis Blues,2015/02/05  vs. BUF,BUF,1,54,37,17,19,-2,0,15,39,23,16,15,1,0,12
St. Louis Blues,2015/01/10  vs. CAR,CAR,1,40,42,-2,-6,0,4,-7,37,36,1,-6,0,7,-4
St. Louis Blues,2015/01/30  vs. CAR,CAR,1,65,48,17,11,6,0,11,42,34,8,10,-2,0,5
St. Louis Blues,2015/02/06  vs. CBJ,CBJ,1,55,43,12,3,0,9,3,44,37,7,1,0,6,1
St. Louis Blues,2015/03/28  vs. CBJ,CBJ,1,40,21,19,6,0,13,3,27,17,10,2,0,8,-1
St. Louis Blues,2014/10/11  vs. CGY,CGY,1,47,35,12,0,12,0,5,36,26,10,0,10,0,3
St. Louis Blues,2015/03/17  vs. CGY,CGY,1,55,51,4,6,-2,0,4,37,33,4,6,-2,0,4
St. Louis Blues,2015/04/02  vs. CGY,CGY,1,59,30,29,0,29,0,22,46,21,25,0,25,0,22
St. Louis Blues,2014/10/25  vs. CHI,CHI,1,40,42,-2,-7,-1,6,3,35,29,6,-2,2,6,7
St. Louis Blues,2014/12/03  vs. CHI,CHI,1,36,49,-13,-6,0,-7,-6,29,34,-5,1,0,-6,2
St. Louis Blues,2015/02/08  vs. CHI,CHI,1,46,47,-1,-1,0,0,5,35,29,6,4,0,2,10
St. Louis Blues,2015/04/05  vs. CHI,CHI,1,37,65,-28,-7,-21,0,-11,29,43,-14,-1,-11,-2,-7
St. Louis Blues,2015/04/09  vs. CHI,CHI,1,32,41,-9,-8,-1,0,-6,22,24,-2,-2,0,0,0
St. Louis Blues,2014/11/01  vs. COL,COL,1,39,31,8,1,7,0,6,28,21,7,2,5,0,5
St. Louis Blues,2014/12/13  vs. COL,COL,1,49,34,15,9,6,0,15,38,22,16,11,5,0,16
St. Louis Blues,2014/12/23  vs. COL,COL,1,38,42,-4,-7,0,3,-5,26,34,-8,-4,0,-4,-2
St. Louis Blues,2014/12/29  vs. COL,COL,1,53,31,22,3,19,0,12,44,21,23,3,20,0,11
St. Louis Blues,2015/01/19  vs. COL,COL,1,48,27,21,6,15,0,17,42,19,23,4,19,0,14
St. Louis Blues,2014/10/28  vs. DAL,DAL,1,34,43,-9,-6,0,-3,-8,24,32,-8,-7,0,-1,-9
St. Louis Blues,2014/12/27  vs. DAL,DAL,1,56,38,18,6,0,12,13,42,27,15,1,0,14,7
St. Louis Blues,2015/02/17  vs. DAL,DAL,1,42,29,13,-2,0,15,-4,26,23,3,-1,0,4,-1
St. Louis Blues,2015/03/15  vs. DAL,DAL,1,29,45,-16,-10,-6,0,-10,22,31,-9,-7,-2,0,-7
St. Louis Blues,2015/04/03  vs. DAL,DAL,1,27,44,-17,-5,-6,-6,-10,18,32,-14,-10,-2,-2,-12
St. Louis Blues,2015/01/15  vs. DET,DET,1,31,41,-10,-11,0,1,-13,23,25,-2,-2,0,0,-4
St. Louis Blues,2015/03/22  vs. DET,DET,1,29,26,3,5,-2,0,3,22,18,4,4,0,0,4
St. Louis Blues,2014/11/28  vs. EDM,EDM,1,56,37,19,10,2,7,11,47,25,22,11,4,7,14
St. Louis Blues,2015/01/13  vs. EDM,EDM,1,39,30,9,6,3,0,7,33,20,13,4,9,0,5
St. Louis Blues,2015/02/28  vs. EDM,EDM,1,56,46,10,18,-8,0,15,42,31,11,16,-5,0,13
St. Louis Blues,2014/12/08  vs. FLA,FLA,1,31,42,-11,-1,-10,0,-3,24,35,-11,-2,-9,0,-5
St. Louis Blues,2015/02/15  vs. FLA,FLA,1,49,38,11,18,-7,0,13,40,31,9,13,-4,0,9
St. Louis Blues,2014/10/16  vs. LAK,LAK,1,53,33,20,20,0,0,20,39,26,13,13,0,0,13
St. Louis Blues,2014/12/16  vs. LAK,LAK,1,32,28,4,-2,1,5,-3,23,22,1,-1,1,1,-3
St. Louis Blues,2014/12/18  vs. LAK,LAK,1,37,50,-13,-9,1,-5,-12,28,41,-13,-11,2,-4,-12
St. Louis Blues,2014/11/29  vs. MIN,MIN,1,32,53,-21,-16,-2,-3,-18,25,42,-17,-12,-1,-4,-13
St. Louis Blues,2015/03/14  vs. MIN,MIN,1,63,27,36,34,1,1,35,47,19,28,29,1,-2,30
St. Louis Blues,2015/03/21  vs. MIN,MIN,1,46,36,10,7,0,3,5,34,28,6,4,0,2,2
St. Louis Blues,2015/04/11  vs. MIN,MIN,1,41,33,8,-2,10,0,0,27,20,7,-4,11,0,-2
St. Louis Blues,2014/11/20  vs. MTL,MTL,1,54,54,0,-3,-7,10,-11,42,39,3,-3,-1,7,-5
St. Louis Blues,2015/02/24  vs. MTL,MTL,1,52,37,15,-2,0,17,2,40,30,10,-5,0,15,-2
St. Louis Blues,2014/11/04  vs. NJD,NJD,1,33,39,-6,-3,-3,0,-3,26,28,-2,-1,-1,0,-1
St. Louis Blues,2014/11/06  vs. NJD,NJD,1,41,42,-1,2,-3,0,-1,32,31,1,2,-1,0,-2
St. Louis Blues,2014/11/08  vs. NSH,NSH,1,50,46,4,8,-2,-2,6,38,38,0,7,-5,-2,2
St. Louis Blues,2014/11/13  vs. NSH,NSH,1,34,44,-10,5,-15,0,-8,26,29,-3,3,-6,0,-2
St. Louis Blues,2014/12/04  vs. NSH,NSH,1,40,49,-9,3,-15,3,-10,32,31,1,2,-10,9,-2
St. Louis Blues,2014/12/30  vs. NSH,NSH,1,39,61,-22,-20,1,-3,-20,27,50,-23,-23,0,0,-24
St. Louis Blues,2015/01/29  vs. NSH,NSH,1,34,38,-4,2,-5,-1,3,31,35,-4,2,-5,-1,3
St. Louis Blues,2014/12/06  vs. NYI,NYI,1,50,39,11,-16,9,18,-4,35,28,7,-9,7,9,-1
St. Louis Blues,2014/12/11  vs. NYI,NYI,1,42,48,-6,-5,-1,0,-3,35,34,1,-2,3,0,-1
St. Louis Blues,2014/10/09  vs. NYR,NYR,1,43,39,4,3,0,1,5,29,27,2,4,0,-2,4
St. Louis Blues,2014/11/03  vs. NYR,NYR,1,42,49,-7,7,-7,-7,1,35,37,-2,5,-2,-5,0
St. Louis Blues,2014/11/22  vs. OTT,OTT,1,42,43,-1,-1,0,0,-5,33,30,3,0,3,0,-4
St. Louis Blues,2014/11/25  vs. OTT,OTT,1,22,45,-23,-5,-18,0,-12,17,25,-8,-2,-6,0,-3
St. Louis Blues,2015/03/05  vs. PHI,PHI,1,48,56,-8,-8,1,-1,-9,31,41,-10,-3,-4,-3,-9
St. Louis Blues,2015/03/12  vs. PHI,PHI,1,52,41,11,11,0,0,11,38,24,14,14,0,0,14
St. Louis Blues,2015/02/21  vs. PIT,PIT,1,40,43,-3,0,0,-3,-4,30,32,-2,1,0,-3,-2
St. Louis Blues,2015/03/24  vs. PIT,PIT,1,48,43,5,1,0,4,4,35,33,2,0,0,2,2
St. Louis Blues,2014/12/20  vs. SJS,SJS,1,46,51,-5,7,-10,-2,6,33,34,-1,9,-8,-2,8
St. Louis Blues,2015/01/03  vs. SJS,SJS,1,53,33,20,14,8,-2,17,38,17,21,13,10,-2,15
St. Louis Blues,2015/01/08  vs. SJS,SJS,1,46,34,12,4,8,0,6,39,28,11,4,7,0,5
St. Louis Blues,2015/02/03  vs. TBL,TBL,1,40,48,-8,-6,0,-2,-9,32,39,-7,-4,0,-3,-4
St. Louis Blues,2015/02/12  vs. TBL,TBL,1,50,44,6,2,4,0,8,43,36,7,1,6,0,7
St. Louis Blues,2015/01/17  vs. TOR,TOR,1,55,54,1,-15,16,0,-1,43,41,2,-15,17,0,2
St. Louis Blues,2015/03/07  vs. TOR,TOR,1,43,25,18,14,4,0,14,34,20,14,9,5,0,9
St. Louis Blues,2014/10/23  vs. VAN,VAN,1,49,32,17,-6,0,23,1,32,26,6,-4,0,10,-3
St. Louis Blues,2015/03/01  vs. VAN,VAN,1,46,40,6,2,-1,5,2,33,28,5,2,-1,4,2
St. Louis Blues,2015/03/30  vs. VAN,VAN,1,57,36,21,7,0,14,9,40,26,14,5,0,9,6
St. Louis Blues,2014/11/23  vs. WPG,WPG,1,36,46,-10,-9,-4,3,-6,27,34,-7,-6,-1,0,-6
St. Louis Blues,2015/02/26  vs. WPG,WPG,1,38,55,-17,-14,-3,0,-15,26,35,-9,-7,-2,0,-8
St. Louis Blues,2015/03/10  vs. WPG,WPG,1,30,30,0,2,0,-2,-3,22,21,1,0,2,-1,-1
St. Louis Blues,2015/03/19  vs. WPG,WPG,1,37,51,-14,-10,-4,0,-19,29,35,-6,-6,0,0,-12
St. Louis Blues,2015/04/07  vs. WPG,WPG,1,46,47,-1,-6,0,5,-15,37,38,-1,-5,0,4,-13
St. Louis Blues,2014/11/15  vs. WSH,WSH,1,49,45,4,12,-8,0,10,41,35,6,9,-3,0,9
St. Louis Blues,2015/02/01  vs. WSH,WSH,1,49,49,0,3,-3,0,1,38,36,2,4,-2,0,1
Tampa Bay Lightning,2015/02/08  vs. ANA,ANA,1,28,41,-13,0,-13,0,0,22,29,-7,0,-7,0,0
Tampa Bay Lightning,2015/02/18  vs. ANA,ANA,1,47,53,-6,-5,-10,9,3,37,38,-1,0,-8,7,7
Tampa Bay Lightning,2014/10/28  vs. ARI,ARI,1,55,52,3,1,2,0,6,44,36,8,2,6,0,6
Tampa Bay Lightning,2015/02/21  vs. ARI,ARI,1,46,47,-1,0,-6,5,8,31,38,-7,-4,-6,3,2
Tampa Bay Lightning,2015/01/13  vs. BOS,BOS,1,25,46,-21,-11,2,-12,-11,20,38,-18,-7,3,-14,-6
Tampa Bay Lightning,2015/03/12  vs. BOS,BOS,1,47,38,9,5,0,4,2,38,31,7,7,0,0,2
Tampa Bay Lightning,2015/03/22  vs. BOS,BOS,1,37,48,-11,1,-15,3,5,22,29,-7,1,-11,3,5
Tampa Bay Lightning,2015/04/11  vs. BOS,BOS,1,40,51,-11,-10,-1,0,-9,29,34,-5,-6,1,0,-6
Tampa Bay Lightning,2014/12/02  vs. BUF,BUF,1,58,35,23,23,0,0,23,38,25,13,14,-1,0,14
Tampa Bay Lightning,2014/12/04  vs. BUF,BUF,1,52,22,30,1,29,0,10,36,16,20,2,18,0,6
Tampa Bay Lightning,2014/12/31  vs. BUF,BUF,1,42,26,16,4,12,0,6,30,16,14,5,9,0,5
Tampa Bay Lightning,2015/01/09  vs. BUF,BUF,1,67,31,36,34,2,0,34,56,20,36,31,5,0,34
Tampa Bay Lightning,2015/03/03  vs. BUF,BUF,1,54,41,13,2,11,0,8,38,31,7,-1,8,0,2
Tampa Bay Lightning,2014/12/11  vs. CAR,CAR,1,46,32,14,14,0,0,14,34,27,7,8,-1,0,8
Tampa Bay Lightning,2014/12/27  vs. CAR,CAR,1,55,29,26,1,25,0,24,40,26,14,-1,15,0,16
Tampa Bay Lightning,2015/01/27  vs. CAR,CAR,1,48,28,20,0,0,20,9,37,20,17,0,0,17,6
Tampa Bay Lightning,2014/11/08  vs. CBJ,CBJ,1,54,46,8,8,0,0,10,45,30,15,7,8,0,9
Tampa Bay Lightning,2014/12/06  vs. CBJ,CBJ,1,44,28,16,0,0,16,2,34,22,12,1,0,11,4
Tampa Bay Lightning,2015/01/31  vs. CBJ,CBJ,1,51,29,22,6,16,0,8,36,25,11,-1,12,0,1
Tampa Bay Lightning,2014/10/21  vs. CGY,CGY,1,44,32,12,4,0,8,4,27,25,2,-1,0,3,-1
Tampa Bay Lightning,2014/11/06  vs. CGY,CGY,1,53,39,14,-4,18,0,1,41,26,15,-3,18,0,3
Tampa Bay Lightning,2014/11/11  vs. CHI,CHI,1,37,41,-4,-7,-4,7,-11,27,28,-1,0,-5,4,-5
Tampa Bay Lightning,2015/02/27  vs. CHI,CHI,1,41,33,8,7,1,0,12,30,23,7,5,2,0,10
Tampa Bay Lightning,2015/01/17  vs. COL,COL,1,42,47,-5,-8,3,0,-5,32,39,-7,-9,2,0,-8
Tampa Bay Lightning,2015/02/22  vs. COL,COL,1,49,37,12,5,0,7,6,35,24,11,3,2,6,8
Tampa Bay Lightning,2015/02/05  vs. DAL,DAL,1,53,55,-2,3,-5,0,5,32,49,-17,-4,-13,0,-4
Tampa Bay Lightning,2015/03/07  vs. DAL,DAL,1,45,44,1,0,-5,6,11,33,36,-3,0,-7,4,7
Tampa Bay Lightning,2014/11/09  vs. DET,DET,1,36,28,8,9,-3,2,12,30,16,14,9,2,3,15
Tampa Bay Lightning,2015/01/29  vs. DET,DET,1,49,44,5,5,0,0,5,40,36,4,5,-1,0,4
Tampa Bay Lightning,2015/03/20  vs. DET,DET,1,41,32,9,11,-2,0,13,32,28,4,6,-2,0,7
Tampa Bay Lightning,2015/03/28  vs. DET,DET,1,27,37,-10,-7,0,-3,-10,24,30,-6,-6,0,0,-9
Tampa Bay Lightning,2014/10/20  vs. EDM,EDM,1,41,39,2,-8,4,6,-2,27,30,-3,-6,4,-1,-2
Tampa Bay Lightning,2015/01/15  vs. EDM,EDM,1,42,38,4,8,-3,-1,10,29,29,0,5,-3,-2,6
Tampa Bay Lightning,2014/10/09  vs. FLA,FLA,1,41,28,13,12,2,-1,11,31,21,10,9,2,-1,8
Tampa Bay Lightning,2015/03/01  vs. FLA,FLA,1,43,41,2,3,0,-1,-8,37,28,9,8,0,1,-1
Tampa Bay Lightning,2015/03/24  vs. FLA,FLA,1,42,50,-8,-4,-1,-3,-6,32,39,-7,-3,-3,-1,-4
Tampa Bay Lightning,2015/04/04  vs. FLA,FLA,1,39,53,-14,3,-17,0,-3,30,44,-14,4,-18,0,-1
Tampa Bay Lightning,2015/02/07  vs. LAK,LAK,1,41,37,4,0,0,4,5,30,32,-2,0,0,-2,2
Tampa Bay Lightning,2015/02/16  vs. LAK,LAK,1,35,43,-8,-13,7,-2,-6,27,34,-7,-11,7,-3,-4
Tampa Bay Lightning,2014/10/25  vs. MIN,MIN,1,39,33,6,0,0,6,4,30,27,3,0,0,3,3
Tampa Bay Lightning,2014/11/22  vs. MIN,MIN,1,53,46,7,11,-3,-1,10,39,34,5,8,2,-5,3
Tampa Bay Lightning,2014/10/13  vs. MTL,MTL,1,43,41,2,-4,6,0,0,37,28,9,-3,12,0,3
Tampa Bay Lightning,2015/01/06  vs. MTL,MTL,1,48,30,18,5,12,1,9,34,22,12,4,8,0,5
Tampa Bay Lightning,2015/03/10  vs. MTL,MTL,1,59,36,23,23,0,0,23,33,23,10,10,0,0,10
Tampa Bay Lightning,2015/03/16  vs. MTL,MTL,1,40,41,-1,3,-4,0,-2,30,35,-5,3,-8,0,-3
Tampa Bay Lightning,2015/03/30  vs. MTL,MTL,1,47,42,5,-6,11,0,11,38,23,15,-1,16,0,14
Tampa Bay Lightning,2014/10/14  vs. NJD,NJD,1,37,32,5,3,0,2,2,27,26,1,0,0,1,1
Tampa Bay Lightning,2014/12/19  vs. NJD,NJD,1,38,14,24,-1,0,25,12,28,11,17,-1,0,18,8
Tampa Bay Lightning,2015/04/09  vs. NJD,NJD,1,37,41,-4,-2,-2,0,-4,24,24,0,-2,1,1,0
Tampa Bay Lightning,2015/02/10  vs. NSH,NSH,1,58,44,14,4,0,10,5,40,33,7,-1,0,8,0
Tampa Bay Lightning,2015/03/26  vs. NSH,NSH,1,41,24,17,2,0,15,2,31,18,13,2,0,11,2
Tampa Bay Lightning,2014/11/15  vs. NYI,NYI,1,40,36,4,3,0,1,7,32,27,5,1,3,1,6
Tampa Bay Lightning,2014/11/18  vs. NYI,NYI,1,42,38,4,-2,-2,8,-6,27,30,-3,-3,-2,2,-7
Tampa Bay Lightning,2014/12/20  vs. NYI,NYI,1,42,63,-21,-12,-5,-4,-12,28,49,-21,-14,-2,-5,-14
Tampa Bay Lightning,2014/11/17  vs. NYR,NYR,1,47,42,5,-1,6,0,1,35,24,11,-1,12,0,5
Tampa Bay Lightning,2014/11/26  vs. NYR,NYR,1,44,33,11,2,8,1,13,38,24,14,2,11,1,13
Tampa Bay Lightning,2014/12/01  vs. NYR,NYR,1,40,44,-4,-3,-1,0,2,26,29,-3,-5,1,1,-2
Tampa Bay Lightning,2014/10/11  vs. OTT,OTT,1,46,38,8,-9,19,-2,7,39,28,11,-4,17,-2,10
Tampa Bay Lightning,2014/11/29  vs. OTT,OTT,1,49,41,8,3,-2,7,10,34,33,1,-4,-2,7,3
Tampa Bay Lightning,2015/01/04  vs. OTT,OTT,1,43,24,19,-2,3,18,14,28,13,15,0,6,9,10
Tampa Bay Lightning,2015/04/02  vs. OTT,OTT,1,39,37,2,0,0,2,2,29,27,2,0,0,2,2
Tampa Bay Lightning,2014/10/30  vs. PHI,PHI,1,35,31,4,3,1,0,11,23,24,-1,1,-2,0,4
Tampa Bay Lightning,2014/12/16  vs. PHI,PHI,1,32,43,-11,-7,-3,-1,-7,28,30,-2,1,-2,-1,0
Tampa Bay Lightning,2015/01/12  vs. PHI,PHI,1,45,36,9,-2,0,11,-13,37,24,13,-1,0,14,-8
Tampa Bay Lightning,2014/12/15  vs. PIT,PIT,1,47,39,8,6,0,2,3,29,30,-1,6,0,-7,-2
Tampa Bay Lightning,2014/12/23  vs. PIT,PIT,1,42,43,-1,-1,0,0,-1,33,28,5,-3,8,0,-1
Tampa Bay Lightning,2015/01/02  vs. PIT,PIT,1,45,49,-4,0,0,-4,-3,32,32,0,0,0,0,-2
Tampa Bay Lightning,2014/11/13  vs. SJS,SJS,1,42,53,-11,-7,0,-4,-9,33,38,-5,-5,0,0,-5
Tampa Bay Lightning,2015/02/15  vs. SJS,SJS,1,47,48,-1,-1,0,0,-8,40,40,0,0,0,0,-6
Tampa Bay Lightning,2015/02/03  vs. STL,STL,1,48,40,8,6,2,0,9,39,32,7,4,3,0,4
Tampa Bay Lightning,2015/02/12  vs. STL,STL,1,44,50,-6,-2,0,-4,-8,36,43,-7,-1,0,-6,-7
Tampa Bay Lightning,2014/11/20  vs. TOR,TOR,1,46,38,8,-3,0,11,7,31,23,8,0,0,8,6
Tampa Bay Lightning,2014/12/29  vs. TOR,TOR,1,58,31,27,12,-1,16,15,48,24,24,12,-1,13,13
Tampa Bay Lightning,2015/03/05  vs. TOR,TOR,1,46,45,1,-1,2,0,5,35,31,4,-1,5,0,7
Tampa Bay Lightning,2015/03/31  vs. TOR,TOR,1,47,41,6,-3,0,9,3,40,35,5,-2,0,7,4
Tampa Bay Lightning,2014/10/18  vs. VAN,VAN,1,28,27,1,1,0,0,4,23,16,7,1,6,0,7
Tampa Bay Lightning,2015/01/20  vs. VAN,VAN,1,38,36,2,3,-1,0,7,24,25,-1,-1,0,0,2
Tampa Bay Lightning,2014/10/24  vs. WPG,WPG,1,41,38,3,1,2,0,-4,33,29,4,2,2,0,-1
Tampa Bay Lightning,2015/03/14  vs. WPG,WPG,1,28,37,-9,-7,-1,-1,-7,16,28,-12,-11,-1,0,-11
Tampa Bay Lightning,2014/11/01  vs. WSH,WSH,1,39,46,-7,6,-8,-5,-4,30,40,-10,1,-6,-5,-8
Tampa Bay Lightning,2014/12/09  vs. WSH,WSH,1,49,49,0,3,0,-3,1,41,39,2,3,0,-1,0
Tampa Bay Lightning,2014/12/13  vs. WSH,WSH,1,48,31,17,3,0,14,1,34,21,13,6,0,7,3
Toronto Maple Leafs,2014/12/16  vs. ANA,ANA,1,49,76,-27,-2,-25,0,-7,37,60,-23,1,-24,0,-4
Toronto Maple Leafs,2015/01/14  vs. ANA,ANA,1,38,38,0,0,0,0,-1,29,30,-1,2,0,-3,3
Toronto Maple Leafs,2014/11/04  vs. ARI,ARI,1,34,40,-6,-1,0,-5,-9,25,33,-8,-1,0,-7,-6
Toronto Maple Leafs,2015/01/29  vs. ARI,ARI,1,40,44,-4,-3,-4,3,-7,30,39,-9,-1,-8,0,-9
Toronto Maple Leafs,2014/10/25  vs. BOS,BOS,1,37,45,-8,0,0,-8,-8,25,32,-7,0,0,-7,-8
Toronto Maple Leafs,2014/11/12  vs. BOS,BOS,1,46,58,-12,3,-15,0,-5,40,33,7,5,2,0,4
Toronto Maple Leafs,2014/12/31  vs. BOS,BOS,1,39,48,-9,-16,7,0,-11,29,31,-2,-10,8,0,-4
Toronto Maple Leafs,2015/04/04  vs. BOS,BOS,1,31,58,-27,-25,0,-2,-27,25,44,-19,-17,0,-2,-19
Toronto Maple Leafs,2014/10/28  vs. BUF,BUF,1,50,32,18,11,7,0,10,36,16,20,11,9,0,11
Toronto Maple Leafs,2014/11/15  vs. BUF,BUF,1,53,37,16,10,0,6,9,45,32,13,10,0,3,10
Toronto Maple Leafs,2015/03/11  vs. BUF,BUF,1,35,47,-12,2,-1,-13,-15,25,38,-13,-2,0,-11,-14
Toronto Maple Leafs,2015/04/01  vs. BUF,BUF,1,39,33,6,1,-4,9,-8,26,27,-1,0,-6,5,-7
Toronto Maple Leafs,2014/12/18  vs. CAR,CAR,1,38,52,-14,-14,0,0,-13,31,39,-8,-10,0,2,-9
Toronto Maple Leafs,2015/01/19  vs. CAR,CAR,1,43,35,8,4,0,4,6,34,30,4,2,0,2,4
Toronto Maple Leafs,2015/02/20  vs. CAR,CAR,1,49,46,3,0,0,3,1,33,31,2,0,0,2,1
Toronto Maple Leafs,2014/10/31  vs. CBJ,CBJ,1,39,41,-2,6,-8,0,5,30,29,1,5,-4,0,4
Toronto Maple Leafs,2015/01/09  vs. CBJ,CBJ,1,41,46,-5,7,-11,-1,8,30,34,-4,7,-9,-2,6
Toronto Maple Leafs,2015/04/08  vs. CBJ,CBJ,1,42,42,0,-4,0,4,-7,34,36,-2,-2,0,0,-5
Toronto Maple Leafs,2014/12/09  vs. CGY,CGY,1,42,64,-22,-5,-17,0,-7,32,38,-6,-1,-5,0,-1
Toronto Maple Leafs,2015/03/13  vs. CGY,CGY,1,47,36,11,-2,0,13,-6,26,29,-3,-5,0,2,-9
Toronto Maple Leafs,2014/11/01  vs. CHI,CHI,1,37,56,-19,-13,-8,2,-11,30,43,-13,-5,-8,0,-4
Toronto Maple Leafs,2014/12/21  vs. CHI,CHI,1,46,46,0,-7,0,7,-8,33,35,-2,-7,0,5,-5
Toronto Maple Leafs,2014/10/14  vs. COL,COL,1,47,39,8,6,-1,3,5,36,28,8,7,0,1,7
Toronto Maple Leafs,2014/11/06  vs. COL,COL,1,61,58,3,10,-1,-6,1,39,40,-1,8,0,-9,-2
Toronto Maple Leafs,2014/12/02  vs. DAL,DAL,1,47,45,2,0,2,0,-10,39,35,4,0,4,0,-7
Toronto Maple Leafs,2014/12/23  vs. DAL,DAL,1,28,62,-34,1,-35,0,-7,23,51,-28,0,-28,0,-8
Toronto Maple Leafs,2014/10/17  vs. DET,DET,1,38,49,-11,3,0,-14,2,30,36,-6,5,0,-11,5
Toronto Maple Leafs,2014/10/18  vs. DET,DET,1,42,29,13,13,0,0,13,36,28,8,8,0,0,8
Toronto Maple Leafs,2014/11/22  vs. DET,DET,1,35,46,-11,-12,1,0,-13,28,32,-4,-7,3,0,-7
Toronto Maple Leafs,2014/12/10  vs. DET,DET,1,18,58,-40,-38,0,-2,-38,15,49,-34,-32,0,-2,-32
Toronto Maple Leafs,2014/12/13  vs. DET,DET,1,50,48,2,16,-13,-1,14,41,35,6,15,-8,-1,13
Toronto Maple Leafs,2015/02/07  vs. EDM,EDM,1,54,58,-4,10,-14,0,12,43,45,-2,10,-12,0,10
Toronto Maple Leafs,2015/03/16  vs. EDM,EDM,1,34,40,-6,-1,0,-5,-4,29,32,-3,0,0,-3,-3
Toronto Maple Leafs,2014/12/28  vs. FLA,FLA,1,34,39,-5,-14,2,7,-9,28,36,-8,-13,2,3,-11
Toronto Maple Leafs,2015/02/17  vs. FLA,FLA,1,35,27,8,-2,4,6,-1,26,18,8,-4,2,10,-1
Toronto Maple Leafs,2015/03/03  vs. FLA,FLA,1,44,42,2,5,-3,0,4,34,35,-1,1,-2,0,0
Toronto Maple Leafs,2015/03/26  vs. FLA,FLA,1,50,53,-3,-1,0,-2,-1,37,40,-3,2,0,-5,1
Toronto Maple Leafs,2014/12/14  vs. LAK,LAK,1,38,62,-24,-6,-12,-6,-13,27,45,-18,-5,-8,-5,-11
Toronto Maple Leafs,2015/01/12  vs. LAK,LAK,1,37,43,-6,-1,0,-5,-5,24,37,-13,-1,0,-12,-10
Toronto Maple Leafs,2015/01/02  vs. MIN,MIN,1,46,41,5,3,0,2,7,38,31,7,8,0,-1,8
Toronto Maple Leafs,2015/03/23  vs. MIN,MIN,1,49,47,2,-3,0,5,-15,38,35,3,2,0,1,-10
Toronto Maple Leafs,2014/10/08  vs. MTL,MTL,1,44,50,-6,-6,1,-1,-9,30,41,-11,-8,1,-4,-11
Toronto Maple Leafs,2015/02/14  vs. MTL,MTL,1,35,45,-10,-9,-1,0,-10,23,31,-8,-7,-1,0,-8
Toronto Maple Leafs,2015/02/28  vs. MTL,MTL,1,51,29,22,3,0,19,6,35,20,15,3,0,12,1
Toronto Maple Leafs,2015/04/11  vs. MTL,MTL,1,39,49,-10,-15,5,0,-10,29,34,-5,-11,6,0,-5
Toronto Maple Leafs,2014/12/04  vs. NJD,NJD,1,47,38,9,4,0,5,5,36,31,5,1,0,4,6
Toronto Maple Leafs,2015/01/28  vs. NJD,NJD,1,22,23,-1,0,-1,0,0,16,19,-3,-3,0,0,-3
Toronto Maple Leafs,2015/02/06  vs. NJD,NJD,1,43,25,18,3,0,15,5,37,23,14,2,0,12,3
Toronto Maple Leafs,2014/11/18  vs. NSH,NSH,1,48,48,0,-2,0,2,-1,34,36,-2,-1,0,-1,2
Toronto Maple Leafs,2015/02/03  vs. NSH,NSH,1,37,47,-10,-3,-7,0,3,28,33,-5,-2,-5,2,3
Toronto Maple Leafs,2014/10/21  vs. NYI,NYI,1,33,40,-7,6,-9,-4,4,23,31,-8,5,-8,-5,2
Toronto Maple Leafs,2015/02/12  vs. NYI,NYI,1,49,56,-7,5,0,-12,3,39,41,-2,6,0,-8,7
Toronto Maple Leafs,2015/03/09  vs. NYI,NYI,1,32,58,-26,-13,-13,0,-17,26,44,-18,-9,-9,0,-11
Toronto Maple Leafs,2014/10/12  vs. NYR,NYR,1,45,54,-9,-11,2,0,-4,35,44,-9,-9,0,0,-8
Toronto Maple Leafs,2014/11/08  vs. NYR,NYR,1,49,51,-2,6,-8,0,-1,37,37,0,3,-7,4,4
Toronto Maple Leafs,2015/02/10  vs. NYR,NYR,1,53,57,-4,2,0,-6,-4,41,46,-5,2,0,-7,-5
Toronto Maple Leafs,2014/11/09  vs. OTT,OTT,1,33,52,-19,-3,-11,-5,-6,31,38,-7,0,-7,0,2
Toronto Maple Leafs,2015/01/21  vs. OTT,OTT,1,51,42,9,3,0,6,1,41,31,10,3,0,7,0
Toronto Maple Leafs,2015/03/21  vs. OTT,OTT,1,37,39,-2,4,0,-6,14,28,31,-3,4,0,-7,13
Toronto Maple Leafs,2015/03/28  vs. OTT,OTT,1,51,45,6,-1,0,7,0,39,33,6,0,0,6,0
Toronto Maple Leafs,2015/04/05  vs. OTT,OTT,1,45,66,-21,-18,-3,0,-21,35,50,-15,-14,-1,0,-15
Toronto Maple Leafs,2014/12/20  vs. PHI,PHI,1,37,51,-14,-10,0,-4,-16,29,41,-12,-9,-1,-2,-13
Toronto Maple Leafs,2015/01/31  vs. PHI,PHI,1,53,35,18,0,0,18,3,36,24,12,-1,0,13,5
Toronto Maple Leafs,2015/02/26  vs. PHI,PHI,1,24,53,-29,-10,-19,0,-16,17,40,-23,-7,-16,0,-11
Toronto Maple Leafs,2014/10/11  vs. PIT,PIT,1,32,52,-20,-1,0,-19,-2,24,37,-13,1,0,-14,0
Toronto Maple Leafs,2014/11/14  vs. PIT,PIT,1,37,68,-31,-25,0,-6,-26,28,52,-24,-17,0,-7,-17
Toronto Maple Leafs,2014/11/26  vs. PIT,PIT,1,33,42,-9,-2,0,-7,-7,23,24,-1,0,0,-1,-3
Toronto Maple Leafs,2015/01/15  vs. SJS,SJS,1,49,61,-12,-7,0,-5,-14,32,42,-10,-3,0,-7,-12
Toronto Maple Leafs,2015/03/19  vs. SJS,SJS,1,36,55,-19,-8,0,-11,-12,27,43,-16,-8,0,-8,-8
Toronto Maple Leafs,2015/01/17  vs. STL,STL,1,54,55,-1,15,0,-16,1,41,43,-2,15,0,-17,-2
Toronto Maple Leafs,2015/03/07  vs. STL,STL,1,25,43,-18,-14,0,-4,-14,20,34,-14,-9,0,-5,-9
Toronto Maple Leafs,2014/11/20  vs. TBL,TBL,1,38,46,-8,3,-11,0,-7,23,31,-8,0,-8,0,-6
Toronto Maple Leafs,2014/12/29  vs. TBL,TBL,1,31,58,-27,-12,-16,1,-15,24,48,-24,-12,-13,1,-13
Toronto Maple Leafs,2015/03/05  vs. TBL,TBL,1,45,46,-1,1,0,-2,-5,31,35,-4,1,0,-5,-7
Toronto Maple Leafs,2015/03/31  vs. TBL,TBL,1,41,47,-6,3,-9,0,-3,35,40,-5,2,-7,0,-4
Toronto Maple Leafs,2014/12/06  vs. VAN,VAN,1,36,60,-24,-8,-16,0,-7,29,46,-17,-2,-15,0,-1
Toronto Maple Leafs,2015/03/14  vs. VAN,VAN,1,38,41,-3,-3,0,0,-6,23,34,-11,-2,0,-9,-7
Toronto Maple Leafs,2015/01/03  vs. WPG,WPG,1,21,59,-38,-19,0,-19,-23,16,48,-32,-14,0,-18,-17
Toronto Maple Leafs,2015/02/21  vs. WPG,WPG,1,42,38,4,6,0,-2,1,31,29,2,3,0,-1,1
Toronto Maple Leafs,2014/11/29  vs. WSH,WSH,1,46,54,-8,3,-11,0,5,32,44,-12,-4,-8,0,-5
Toronto Maple Leafs,2015/01/07  vs. WSH,WSH,1,51,42,9,0,0,9,-1,39,35,4,0,0,4,0
Toronto Maple Leafs,2015/03/01  vs. WSH,WSH,1,41,45,-4,-1,0,-3,5,29,33,-4,0,0,-4,3
Vancouver Canucks,2014/11/09  vs. ANA,ANA,1,52,51,1,-1,0,2,1,42,34,8,3,0,5,8
Vancouver Canucks,2014/11/20  vs. ANA,ANA,1,52,37,15,1,-2,16,9,32,25,7,1,1,5,3
Vancouver Canucks,2014/12/28  vs. ANA,ANA,1,45,61,-16,-3,-13,0,-13,34,47,-13,-3,-10,0,-13
Vancouver Canucks,2015/01/27  vs. ANA,ANA,1,32,37,-5,-5,0,0,0,22,28,-6,-4,0,-2,0
Vancouver Canucks,2015/03/09  vs. ANA,ANA,1,30,56,-26,-3,-23,0,-21,22,41,-19,-3,-16,0,-13
Vancouver Canucks,2014/11/14  vs. ARI,ARI,1,51,33,18,9,0,9,16,33,26,7,6,0,1,12
Vancouver Canucks,2014/12/22  vs. ARI,ARI,1,28,62,-34,-4,-30,0,-6,21,45,-24,-3,-21,0,-4
Vancouver Canucks,2015/03/05  vs. ARI,ARI,1,48,45,3,-8,0,11,7,36,33,3,-8,0,11,7
Vancouver Canucks,2015/03/22  vs. ARI,ARI,1,69,61,8,14,-6,0,13,51,42,9,13,-4,0,12
Vancouver Canucks,2015/04/09  vs. ARI,ARI,1,42,37,5,7,-2,0,15,31,29,2,2,0,0,7
Vancouver Canucks,2015/02/13  vs. BOS,BOS,1,42,47,-5,1,-6,0,2,32,32,0,1,-1,0,2
Vancouver Canucks,2015/02/24  vs. BOS,BOS,1,36,53,-17,-9,-8,0,-9,31,40,-9,-5,-4,0,-5
Vancouver Canucks,2015/01/30  vs. BUF,BUF,1,58,12,46,3,34,9,26,41,11,30,3,22,5,18
Vancouver Canucks,2015/02/26  vs. BUF,BUF,1,52,27,25,15,6,4,20,36,25,11,3,6,2,8
Vancouver Canucks,2014/10/28  vs. CAR,CAR,1,38,40,-2,-1,-1,0,6,30,30,0,-1,1,0,6
Vancouver Canucks,2015/01/16  vs. CAR,CAR,1,32,48,-16,-7,-9,0,-10,23,35,-12,-7,-5,0,-9
Vancouver Canucks,2014/11/28  vs. CBJ,CBJ,1,41,45,-4,2,-6,0,1,34,37,-3,0,-3,0,2
Vancouver Canucks,2015/03/19  vs. CBJ,CBJ,1,65,49,16,4,1,11,1,51,35,16,7,3,6,6
Vancouver Canucks,2014/10/08  vs. CGY,CGY,1,41,38,3,-4,7,0,8,31,28,3,-2,5,0,7
Vancouver Canucks,2014/12/20  vs. CGY,CGY,1,54,45,9,3,6,0,3,38,30,8,3,5,0,1
Vancouver Canucks,2015/01/10  vs. CGY,CGY,1,73,38,35,9,0,26,23,51,25,26,8,0,18,22
Vancouver Canucks,2015/02/14  vs. CGY,CGY,1,50,45,5,1,2,2,4,34,38,-4,-3,2,-3,-3
Vancouver Canucks,2014/11/23  vs. CHI,CHI,1,51,38,13,14,-1,0,19,38,26,12,8,4,0,13
Vancouver Canucks,2015/02/11  vs. CHI,CHI,1,51,56,-5,7,-13,1,9,40,38,2,8,-4,-2,9
Vancouver Canucks,2015/04/02  vs. CHI,CHI,1,45,44,1,-6,0,7,-6,33,34,-1,-4,0,3,-8
Vancouver Canucks,2014/10/24  vs. COL,COL,1,36,52,-16,-1,-8,-7,-11,30,45,-15,-1,-10,-4,-13
Vancouver Canucks,2014/11/04  vs. COL,COL,1,56,31,25,0,2,23,7,38,21,17,0,2,15,3
Vancouver Canucks,2015/03/26  vs. COL,COL,1,48,40,8,-8,0,16,-15,30,30,0,-8,0,8,-13
Vancouver Canucks,2014/10/21  vs. DAL,DAL,1,51,32,19,2,0,17,2,45,26,19,3,0,16,4
Vancouver Canucks,2014/12/17  vs. DAL,DAL,1,32,43,-11,3,0,-14,-12,26,33,-7,3,0,-10,-10
Vancouver Canucks,2015/03/28  vs. DAL,DAL,1,47,55,-8,-7,-6,5,0,38,46,-8,-7,-3,2,-4
Vancouver Canucks,2014/11/30  vs. DET,DET,1,38,42,-4,-1,0,-3,-4,31,28,3,-1,0,4,-1
Vancouver Canucks,2015/01/03  vs. DET,DET,1,32,35,-3,2,-5,0,-2,23,24,-1,3,-4,0,-2
Vancouver Canucks,2014/10/11  vs. EDM,EDM,1,43,36,7,-5,0,12,6,36,28,8,-3,0,11,7
Vancouver Canucks,2014/10/17  vs. EDM,EDM,1,47,40,7,14,-7,0,15,32,27,5,8,-3,0,9
Vancouver Canucks,2014/11/01  vs. EDM,EDM,1,42,41,1,-2,3,0,-1,37,30,7,1,4,2,4
Vancouver Canucks,2014/11/19  vs. EDM,EDM,1,47,42,5,1,4,0,4,34,31,3,0,3,0,-1
Vancouver Canucks,2015/04/11  vs. EDM,EDM,1,43,50,-7,-2,0,-5,-6,29,32,-3,-2,0,-1,-3
Vancouver Canucks,2015/01/08  vs. FLA,FLA,1,41,41,0,-3,-1,4,0,34,33,1,-1,1,1,1
Vancouver Canucks,2015/01/19  vs. FLA,FLA,1,30,35,-5,2,-7,0,-1,23,26,-3,2,-5,0,0
Vancouver Canucks,2014/11/08  vs. LAK,LAK,1,26,53,-27,-1,0,-26,-4,20,47,-27,-2,0,-25,-5
Vancouver Canucks,2015/01/01  vs. LAK,LAK,1,28,61,-33,-8,-24,-1,-16,19,47,-28,-8,-19,-1,-16
Vancouver Canucks,2015/03/12  vs. LAK,LAK,1,36,47,-11,-2,0,-9,-2,25,29,-4,2,0,-6,2
Vancouver Canucks,2015/03/21  vs. LAK,LAK,1,54,43,11,10,-1,2,12,41,24,17,13,-1,5,18
Vancouver Canucks,2015/04/06  vs. LAK,LAK,1,45,42,3,-3,0,6,1,34,34,0,0,0,0,0
Vancouver Canucks,2015/02/01  vs. MIN,MIN,1,42,26,16,6,0,10,5,32,23,9,4,0,5,3
Vancouver Canucks,2015/02/09  vs. MIN,MIN,1,48,39,9,5,0,4,-4,38,29,9,6,0,3,0
Vancouver Canucks,2015/02/16  vs. MIN,MIN,1,43,45,-2,1,-7,4,5,35,27,8,4,0,4,8
Vancouver Canucks,2014/10/30  vs. MTL,MTL,1,51,38,13,8,5,0,10,39,28,11,6,5,0,8
Vancouver Canucks,2014/12/09  vs. MTL,MTL,1,23,49,-26,-18,0,-8,-22,15,31,-16,-8,0,-8,-13
Vancouver Canucks,2014/11/25  vs. NJD,NJD,1,52,39,13,10,3,0,10,42,28,14,9,5,0,11
Vancouver Canucks,2015/02/20  vs. NJD,NJD,1,31,34,-3,-4,0,1,-6,26,28,-2,-1,0,-1,-3
Vancouver Canucks,2014/11/02  vs. NSH,NSH,1,42,48,-6,2,-1,-7,1,31,34,-3,0,0,-3,0
Vancouver Canucks,2015/01/13  vs. NSH,NSH,1,51,40,11,3,0,8,2,39,30,9,2,0,7,0
Vancouver Canucks,2015/03/31  vs. NSH,NSH,1,32,32,0,0,3,-3,2,24,25,-1,0,3,-4,2
Vancouver Canucks,2015/01/06  vs. NYI,NYI,1,36,47,-11,1,-12,0,3,24,25,-1,3,-4,0,6
Vancouver Canucks,2015/02/22  vs. NYI,NYI,1,26,43,-17,-1,-16,0,-3,21,32,-11,1,-12,0,0
Vancouver Canucks,2014/12/13  vs. NYR,NYR,1,50,34,16,2,0,14,1,34,27,7,0,0,7,-1
Vancouver Canucks,2015/02/19  vs. NYR,NYR,1,41,40,1,-1,0,2,-8,30,32,-2,-2,0,0,-8
Vancouver Canucks,2014/11/11  vs. OTT,OTT,1,46,39,7,13,-6,0,9,36,27,9,13,-4,0,11
Vancouver Canucks,2014/12/07  vs. OTT,OTT,1,43,49,-6,-6,0,0,-5,32,33,-1,-5,4,0,-3
Vancouver Canucks,2015/01/15  vs. PHI,PHI,1,43,55,-12,-9,-3,0,-7,32,35,-3,-7,4,0,-3
Vancouver Canucks,2015/03/17  vs. PHI,PHI,1,46,46,0,-7,3,4,-3,41,33,8,2,5,1,3
Vancouver Canucks,2014/12/04  vs. PIT,PIT,1,45,33,12,-1,13,0,17,35,23,12,-2,14,0,13
Vancouver Canucks,2015/02/07  vs. PIT,PIT,1,33,45,-12,2,-14,0,0,27,33,-6,2,-8,0,0
Vancouver Canucks,2014/11/06  vs. SJS,SJS,1,20,65,-45,-28,-16,-1,-32,18,44,-26,-18,-7,-1,-19
Vancouver Canucks,2014/12/30  vs. SJS,SJS,1,45,50,-5,0,-5,0,5,33,38,-5,1,-6,0,4
Vancouver Canucks,2015/02/05  vs. SJS,SJS,1,47,51,-4,-6,0,2,-10,36,41,-5,-5,0,0,-9
Vancouver Canucks,2015/03/03  vs. SJS,SJS,1,48,37,11,3,0,8,1,36,28,8,2,0,6,1
Vancouver Canucks,2015/03/07  vs. SJS,SJS,1,47,56,-9,-4,-5,0,-6,33,44,-11,-2,-3,-6,-8
Vancouver Canucks,2014/10/23  vs. STL,STL,1,32,49,-17,6,-23,0,-1,26,32,-6,4,-10,0,3
Vancouver Canucks,2015/03/01  vs. STL,STL,1,40,46,-6,-2,-5,1,-2,28,33,-5,-2,-4,1,-2
Vancouver Canucks,2015/03/30  vs. STL,STL,1,36,57,-21,-7,-14,0,-9,26,40,-14,-5,-9,0,-6
Vancouver Canucks,2014/10/18  vs. TBL,TBL,1,27,28,-1,-1,0,0,-4,16,23,-7,-1,0,-6,-7
Vancouver Canucks,2015/01/20  vs. TBL,TBL,1,36,38,-2,-3,0,1,-7,25,24,1,1,0,0,-2
Vancouver Canucks,2014/12/06  vs. TOR,TOR,1,60,36,24,8,0,16,7,46,29,17,2,0,15,1
Vancouver Canucks,2015/03/14  vs. TOR,TOR,1,41,38,3,3,0,0,6,34,23,11,2,9,0,7
Vancouver Canucks,2015/02/03  vs. WPG,WPG,1,36,38,-2,3,0,-5,0,26,28,-2,1,0,-3,-1
Vancouver Canucks,2015/03/24  vs. WPG,WPG,1,38,43,-5,3,-4,-4,2,28,29,-1,3,1,-5,1
Vancouver Canucks,2015/04/04  vs. WPG,WPG,1,38,52,-14,-3,0,-11,-6,30,41,-11,-3,0,-8,-6
Vancouver Canucks,2014/10/26  vs. WSH,WSH,1,43,41,2,0,2,0,0,34,30,4,1,3,0,1
Vancouver Canucks,2014/12/02  vs. WSH,WSH,1,45,57,-12,-1,-11,0,-7,34,34,0,5,-5,0,2
Washington Capitals,2015/02/06  vs. ANA,ANA,1,56,42,14,12,2,0,12,42,26,16,14,3,-1,13
Washington Capitals,2015/02/15  vs. ANA,ANA,1,45,47,-2,-7,5,0,-3,35,36,-1,-6,5,0,-6
Washington Capitals,2014/11/02  vs. ARI,ARI,1,42,45,-3,4,-7,0,0,30,31,-1,3,-6,2,-1
Washington Capitals,2014/11/18  vs. ARI,ARI,1,30,32,-2,-3,1,0,-2,20,21,-1,-3,2,0,-1
Washington Capitals,2014/10/11  vs. BOS,BOS,1,25,42,-17,-1,-16,0,-8,18,33,-15,-2,-13,0,-9
Washington Capitals,2015/03/15  vs. BOS,BOS,1,57,47,10,7,3,0,4,47,31,16,8,8,0,10
Washington Capitals,2015/04/08  vs. BOS,BOS,1,50,64,-14,-3,-11,0,2,40,46,-6,-2,-4,0,3
Washington Capitals,2014/11/22  vs. BUF,BUF,1,67,39,28,17,0,11,25,48,25,23,17,0,6,22
Washington Capitals,2015/03/07  vs. BUF,BUF,1,71,34,37,21,18,-2,20,52,24,28,14,16,-2,13
Washington Capitals,2015/03/16  vs. BUF,BUF,1,60,39,21,6,6,9,15,37,32,5,1,3,1,2
Washington Capitals,2014/11/08  vs. CAR,CAR,1,54,48,6,2,4,0,6,35,30,5,8,-3,0,6
Washington Capitals,2014/12/04  vs. CAR,CAR,1,58,54,4,2,2,0,4,34,33,1,-2,3,0,0
Washington Capitals,2015/02/27  vs. CAR,CAR,1,47,53,-6,-3,0,-3,-3,33,38,-5,-1,0,-4,1
Washington Capitals,2015/03/31  vs. CAR,CAR,1,41,42,-1,0,-1,0,1,30,30,0,-1,1,0,1
Washington Capitals,2014/11/11  vs. CBJ,CBJ,1,36,46,-10,-1,-9,0,-2,27,29,-2,-2,0,0,-2
Washington Capitals,2014/12/11  vs. CBJ,CBJ,1,41,35,6,5,1,0,7,29,27,2,-2,4,0,2
Washington Capitals,2014/12/18  vs. CBJ,CBJ,1,44,30,14,9,-1,6,5,34,27,7,6,-3,4,3
Washington Capitals,2015/01/27  vs. CBJ,CBJ,1,38,32,6,9,0,-3,10,32,27,5,8,0,-3,10
Washington Capitals,2015/03/03  vs. CBJ,CBJ,1,35,40,-5,3,-8,0,3,31,27,4,3,1,0,5
Washington Capitals,2014/10/25  vs. CGY,CGY,1,40,35,5,6,-1,0,3,32,25,7,6,1,0,6
Washington Capitals,2014/11/04  vs. CGY,CGY,1,56,43,13,12,2,-1,12,37,28,9,8,3,-2,7
Washington Capitals,2014/11/07  vs. CHI,CHI,1,27,53,-26,-9,-10,-7,-6,24,39,-15,-5,-6,-4,-4
Washington Capitals,2015/01/01  vs. CHI,CHI,1,44,42,2,0,2,0,1,38,34,4,2,2,0,3
Washington Capitals,2014/11/20  vs. COL,COL,1,46,46,0,12,-12,0,10,30,35,-5,3,-8,0,3
Washington Capitals,2015/01/12  vs. COL,COL,1,62,40,22,10,12,0,24,48,28,20,9,11,0,23
Washington Capitals,2015/01/17  vs. DAL,DAL,1,55,35,20,0,0,20,3,35,25,10,1,0,9,2
Washington Capitals,2015/03/13  vs. DAL,DAL,1,33,41,-8,-2,0,-6,-14,23,30,-7,-3,0,-4,-9
Washington Capitals,2014/10/29  vs. DET,DET,1,36,27,9,9,-1,1,9,25,18,7,6,1,0,6
Washington Capitals,2015/01/10  vs. DET,DET,1,26,52,-26,3,-29,0,-11,18,34,-16,1,-17,0,-11
Washington Capitals,2015/04/05  vs. DET,DET,1,35,36,-1,2,-3,0,0,29,25,4,2,2,0,3
Washington Capitals,2014/10/22  vs. EDM,EDM,1,55,30,25,7,1,17,15,41,23,18,7,1,10,14
Washington Capitals,2015/01/20  vs. EDM,EDM,1,50,35,15,2,13,0,6,31,22,9,2,7,0,5
Washington Capitals,2014/10/18  vs. FLA,FLA,1,49,35,14,6,8,0,16,35,25,10,4,6,0,10
Washington Capitals,2014/12/16  vs. FLA,FLA,1,41,43,-2,-8,0,6,-2,28,36,-8,-8,0,0,-8
Washington Capitals,2015/01/04  vs. FLA,FLA,1,50,35,15,16,-2,1,13,33,28,5,8,-5,2,6
Washington Capitals,2015/02/03  vs. LAK,LAK,1,35,42,-7,1,-8,0,5,28,33,-5,1,-6,0,4
Washington Capitals,2015/02/14  vs. LAK,LAK,1,37,56,-19,-25,0,6,-26,28,43,-15,-18,0,3,-21
Washington Capitals,2015/03/05  vs. MIN,MIN,1,42,53,-11,-1,-14,4,-8,32,38,-6,-1,-7,2,-4
Washington Capitals,2015/03/19  vs. MIN,MIN,1,37,36,1,5,-4,0,5,28,26,2,3,-1,0,3
Washington Capitals,2014/10/09  vs. MTL,MTL,1,41,27,14,6,8,0,13,30,18,12,2,10,0,11
Washington Capitals,2015/01/31  vs. MTL,MTL,1,48,44,4,4,0,0,4,32,27,5,5,0,0,5
Washington Capitals,2015/04/02  vs. MTL,MTL,1,33,48,-15,-7,-6,-2,-9,17,25,-8,-5,-2,-1,-5
Washington Capitals,2014/10/16  vs. NJD,NJD,1,35,45,-10,-5,-5,0,-9,26,31,-5,-4,-1,0,-5
Washington Capitals,2014/11/14  vs. NJD,NJD,1,34,36,-2,-6,0,4,-6,27,24,3,-2,0,5,-2
Washington Capitals,2014/12/06  vs. NJD,NJD,1,33,55,-22,-1,-21,0,2,31,41,-10,5,-15,0,10
Washington Capitals,2014/12/20  vs. NJD,NJD,1,22,28,-6,-6,0,0,-7,18,25,-7,-5,-2,0,-7
Washington Capitals,2015/03/26  vs. NJD,NJD,1,38,34,4,-1,5,0,4,25,29,-4,-2,-2,0,0
Washington Capitals,2015/01/16  vs. NSH,NSH,1,52,41,11,19,-2,-6,15,41,24,17,18,1,-2,18
Washington Capitals,2015/03/28  vs. NSH,NSH,1,47,47,0,-3,0,3,-10,33,35,-2,-3,0,1,-9
Washington Capitals,2014/11/26  vs. NYI,NYI,1,38,57,-19,-18,0,-1,-19,32,41,-9,-10,0,1,-9
Washington Capitals,2014/11/28  vs. NYI,NYI,1,63,55,8,6,2,0,9,37,39,-2,2,-4,0,2
Washington Capitals,2014/12/29  vs. NYI,NYI,1,40,47,-7,-4,0,-3,-2,25,38,-13,-4,0,-9,-9
Washington Capitals,2015/02/21  vs. NYI,NYI,1,58,61,-3,9,-9,-3,6,33,40,-7,0,-5,-2,-2
Washington Capitals,2014/12/23  vs. NYR,NYR,1,42,23,19,1,0,18,-4,30,17,13,0,0,13,-4
Washington Capitals,2015/03/11  vs. NYR,NYR,1,52,34,18,-3,0,21,-6,36,27,9,-4,0,13,-5
Washington Capitals,2015/03/29  vs. NYR,NYR,1,38,32,6,12,-3,-3,6,30,26,4,8,-3,-1,3
Washington Capitals,2015/04/11  vs. NYR,NYR,1,48,32,16,2,0,14,2,33,26,7,2,0,5,2
Washington Capitals,2014/12/22  vs. OTT,OTT,1,45,45,0,8,-8,0,6,29,31,-2,5,-7,0,3
Washington Capitals,2015/02/05  vs. OTT,OTT,1,50,32,18,11,6,1,15,33,23,10,1,9,0,4
Washington Capitals,2015/04/04  vs. OTT,OTT,1,56,34,22,7,0,15,0,44,26,18,4,0,14,-1
Washington Capitals,2015/01/08  vs. PHI,PHI,1,46,54,-8,-4,-4,0,-6,27,35,-8,-4,-4,0,-7
Washington Capitals,2015/01/14  vs. PHI,PHI,1,45,40,5,2,3,0,7,32,24,8,1,7,0,7
Washington Capitals,2015/02/08  vs. PHI,PHI,1,41,41,0,-11,0,11,-8,25,29,-4,-8,0,4,-9
Washington Capitals,2015/02/22  vs. PHI,PHI,1,36,40,-4,-10,0,6,-3,25,30,-5,-7,0,2,-4
Washington Capitals,2014/12/27  vs. PIT,PIT,1,44,36,8,6,2,0,9,35,28,7,5,2,0,9
Washington Capitals,2015/01/28  vs. PIT,PIT,1,43,48,-5,-1,-4,0,-10,31,28,3,-1,4,0,1
Washington Capitals,2015/02/17  vs. PIT,PIT,1,39,38,1,1,0,0,0,33,28,5,4,1,0,4
Washington Capitals,2015/02/25  vs. PIT,PIT,1,31,35,-4,-13,0,9,-12,22,25,-3,-8,0,5,-7
Washington Capitals,2014/10/14  vs. SJS,SJS,1,55,37,18,-1,0,19,1,36,22,14,1,0,13,2
Washington Capitals,2015/02/11  vs. SJS,SJS,1,46,57,-11,-4,5,-12,-7,35,44,-9,-5,4,-8,-5
Washington Capitals,2014/11/15  vs. STL,STL,1,45,49,-4,-12,0,8,-10,35,41,-6,-9,0,3,-9
Washington Capitals,2015/02/01  vs. STL,STL,1,49,49,0,-3,0,3,-1,36,38,-2,-4,0,2,-1
Washington Capitals,2014/11/01  vs. TBL,TBL,1,46,39,7,-6,5,8,4,40,30,10,-1,5,6,8
Washington Capitals,2014/12/09  vs. TBL,TBL,1,49,49,0,-3,3,0,-1,39,41,-2,-3,1,0,0
Washington Capitals,2014/12/13  vs. TBL,TBL,1,31,48,-17,-3,-14,0,-1,21,34,-13,-6,-7,0,-3
Washington Capitals,2014/11/29  vs. TOR,TOR,1,54,46,8,-3,0,11,-5,44,32,12,4,0,8,5
Washington Capitals,2015/01/07  vs. TOR,TOR,1,42,51,-9,0,-9,0,1,35,39,-4,0,-4,0,0
Washington Capitals,2015/03/01  vs. TOR,TOR,1,45,41,4,1,3,0,-5,33,29,4,0,4,0,-3
Washington Capitals,2014/10/26  vs. VAN,VAN,1,41,43,-2,0,0,-2,0,30,34,-4,-1,0,-3,-1
Washington Capitals,2014/12/02  vs. VAN,VAN,1,57,45,12,1,0,11,7,34,34,0,-5,0,5,-2
Washington Capitals,2015/02/19  vs. WPG,WPG,1,32,39,-7,-9,2,0,-4,26,22,4,-4,8,0,0
Washington Capitals,2015/03/21  vs. WPG,WPG,1,55,38,17,2,0,15,1,35,25,10,-3,0,13,-1
Winnipeg Jets,2014/12/07  vs. ANA,ANA,1,44,24,20,7,-2,15,19,32,18,14,6,-2,10,13
Winnipeg Jets,2014/12/13  vs. ANA,ANA,1,47,31,16,5,1,10,9,31,22,9,2,2,5,5
Winnipeg Jets,2015/01/11  vs. ANA,ANA,1,36,41,-5,-1,-4,0,-2,27,33,-6,0,-6,0,-1
Winnipeg Jets,2014/10/09  vs. ARI,ARI,1,22,41,-19,-3,-16,0,-1,17,30,-13,-2,-11,0,0
Winnipeg Jets,2015/01/08  vs. ARI,ARI,1,51,31,20,1,0,19,1,39,27,12,1,0,11,1
Winnipeg Jets,2015/01/18  vs. ARI,ARI,1,42,39,3,-7,10,0,9,35,30,5,-3,8,0,11
Winnipeg Jets,2014/11/28  vs. BOS,BOS,1,43,39,4,5,-1,0,3,33,30,3,2,1,0,1
Winnipeg Jets,2014/12/19  vs. BOS,BOS,1,34,39,-5,-5,0,0,3,24,32,-8,-5,-3,0,3
Winnipeg Jets,2014/11/26  vs. BUF,BUF,1,33,28,5,0,5,0,6,23,22,1,0,1,0,5
Winnipeg Jets,2014/12/16  vs. BUF,BUF,1,52,30,22,8,11,3,9,39,24,15,5,10,0,3
Winnipeg Jets,2014/10/21  vs. CAR,CAR,1,36,33,3,2,1,0,7,29,24,5,1,4,0,6
Winnipeg Jets,2014/11/13  vs. CAR,CAR,1,60,55,5,2,3,0,11,47,40,7,4,3,0,11
Winnipeg Jets,2014/11/25  vs. CBJ,CBJ,1,34,38,-4,5,-9,0,7,24,31,-7,-1,-6,0,1
Winnipeg Jets,2015/01/21  vs. CBJ,CBJ,1,45,43,2,-1,3,0,0,38,29,9,-1,10,0,-4
Winnipeg Jets,2014/10/19  vs. CGY,CGY,1,58,39,19,5,1,13,3,40,34,6,5,-4,5,-2
Winnipeg Jets,2015/02/02  vs. CGY,CGY,1,54,36,18,3,4,11,11,35,29,6,0,1,5,6
Winnipeg Jets,2015/04/11  vs. CGY,CGY,1,33,41,-8,-12,5,-1,-13,22,31,-9,-9,1,-1,-10
Winnipeg Jets,2014/11/02  vs. CHI,CHI,1,38,67,-29,1,-30,0,-16,29,40,-11,1,-12,0,-6
Winnipeg Jets,2014/12/23  vs. CHI,CHI,1,49,62,-13,8,-21,0,10,32,45,-13,5,-18,0,7
Winnipeg Jets,2015/01/16  vs. CHI,CHI,1,41,43,-2,2,-6,2,4,33,27,6,7,-2,1,8
Winnipeg Jets,2015/02/06  vs. CHI,CHI,1,37,41,-4,-1,-3,0,-4,25,30,-5,-6,1,0,-5
Winnipeg Jets,2015/03/29  vs. CHI,CHI,1,38,45,-7,-4,1,-4,-8,31,28,3,3,2,-2,1
Winnipeg Jets,2014/10/26  vs. COL,COL,1,60,33,27,25,2,0,27,34,19,15,15,0,0,15
Winnipeg Jets,2014/12/05  vs. COL,COL,1,48,31,17,8,9,0,16,37,24,13,5,8,0,10
Winnipeg Jets,2014/12/11  vs. COL,COL,1,46,34,12,10,2,0,17,32,24,8,9,-1,0,13
Winnipeg Jets,2015/02/08  vs. COL,COL,1,45,35,10,0,5,5,9,31,26,5,-3,0,8,4
Winnipeg Jets,2015/04/09  vs. COL,COL,1,41,24,17,17,0,0,17,33,18,15,15,0,0,15
Winnipeg Jets,2014/12/09  vs. DAL,DAL,1,50,47,3,6,-3,0,8,38,32,6,4,2,0,6
Winnipeg Jets,2015/01/15  vs. DAL,DAL,1,31,55,-24,-1,-23,0,-19,24,41,-17,1,-18,0,-14
Winnipeg Jets,2015/01/31  vs. DAL,DAL,1,74,30,44,-6,0,50,29,49,27,22,-5,0,27,17
Winnipeg Jets,2015/02/24  vs. DAL,DAL,1,38,60,-22,-1,-21,0,-12,33,43,-10,-2,-8,0,-6
Winnipeg Jets,2014/11/20  vs. DET,DET,1,50,36,14,8,4,2,14,37,25,12,4,6,2,10
Winnipeg Jets,2015/02/14  vs. DET,DET,1,36,31,5,5,-2,2,6,33,26,7,7,-1,1,7
Winnipeg Jets,2014/12/03  vs. EDM,EDM,1,51,39,12,13,0,-1,13,31,29,2,2,1,-1,3
Winnipeg Jets,2015/02/16  vs. EDM,EDM,1,53,24,29,24,4,1,30,42,19,23,19,2,2,24
Winnipeg Jets,2015/03/23  vs. EDM,EDM,1,49,44,5,4,1,0,6,29,37,-8,2,-10,0,3
Winnipeg Jets,2015/01/13  vs. FLA,FLA,1,53,35,18,3,15,0,1,41,28,13,3,10,0,1
Winnipeg Jets,2015/03/12  vs. FLA,FLA,1,36,33,3,4,0,-1,1,26,28,-2,3,0,-5,0
Winnipeg Jets,2014/10/12  vs. LAK,LAK,1,37,47,-10,-2,0,-8,-3,34,39,-5,-2,0,-3,-3
Winnipeg Jets,2015/01/10  vs. LAK,LAK,1,26,39,-13,-5,-10,2,-15,23,31,-8,-5,-5,2,-11
Winnipeg Jets,2015/03/01  vs. LAK,LAK,1,39,40,-1,1,-2,0,-2,34,29,5,4,1,0,6
Winnipeg Jets,2014/11/16  vs. MIN,MIN,1,32,25,7,-4,0,11,-5,21,21,0,-3,0,3,-3
Winnipeg Jets,2014/12/27  vs. MIN,MIN,1,41,38,3,5,0,-2,3,27,28,-1,4,0,-5,-1
Winnipeg Jets,2014/12/29  vs. MIN,MIN,1,50,51,-1,-12,0,11,-19,29,35,-6,-10,-1,5,-13
Winnipeg Jets,2015/02/10  vs. MIN,MIN,1,54,32,22,21,1,0,21,36,27,9,8,1,0,8
Winnipeg Jets,2015/04/06  vs. MIN,MIN,1,39,48,-9,3,-12,0,3,34,34,0,5,-5,0,9
Winnipeg Jets,2014/11/11  vs. MTL,MTL,1,50,34,16,7,0,9,9,36,27,9,4,0,5,3
Winnipeg Jets,2015/03/26  vs. MTL,MTL,1,42,39,3,-2,5,0,-1,30,32,-2,-2,0,0,-5
Winnipeg Jets,2014/10/30  vs. NJD,NJD,1,28,44,-16,-5,-11,0,-10,24,32,-8,-4,-4,0,-5
Winnipeg Jets,2014/11/18  vs. NJD,NJD,1,50,34,16,6,10,0,7,37,24,13,6,7,0,7
Winnipeg Jets,2014/10/17  vs. NSH,NSH,1,35,40,-5,1,0,-6,-4,25,30,-5,1,0,-6,-4
Winnipeg Jets,2014/11/04  vs. NSH,NSH,1,37,42,-5,-3,-2,0,2,26,29,-3,-1,-2,0,2
Winnipeg Jets,2014/11/15  vs. NSH,NSH,1,46,45,1,8,-6,-1,2,32,37,-5,3,-7,-1,-4
Winnipeg Jets,2015/02/12  vs. NSH,NSH,1,37,27,10,4,0,6,10,27,22,5,1,0,4,5
Winnipeg Jets,2015/03/07  vs. NSH,NSH,1,38,39,-1,2,-3,0,0,28,27,1,3,-2,0,1
Winnipeg Jets,2014/10/28  vs. NYI,NYI,1,36,32,4,6,-1,-1,4,27,27,0,8,-5,-3,3
Winnipeg Jets,2014/12/31  vs. NYI,NYI,1,31,47,-16,-5,0,-11,-9,22,33,-11,-4,0,-7,-4
Winnipeg Jets,2014/11/01  vs. NYR,NYR,1,48,43,5,5,0,0,5,32,33,-1,-1,0,0,-1
Winnipeg Jets,2015/03/31  vs. NYR,NYR,1,68,33,35,28,11,-4,39,45,24,21,19,6,-4,25
Winnipeg Jets,2014/11/08  vs. OTT,OTT,1,45,56,-11,-19,0,8,-11,33,38,-5,-11,0,6,-5
Winnipeg Jets,2015/03/04  vs. OTT,OTT,1,52,29,23,5,0,18,11,36,22,14,5,0,9,7
Winnipeg Jets,2014/12/21  vs. PHI,PHI,1,35,38,-3,0,-5,2,5,27,24,3,0,0,3,7
Winnipeg Jets,2015/01/29  vs. PHI,PHI,1,43,32,11,8,0,3,4,34,25,9,7,0,2,5
Winnipeg Jets,2014/11/06  vs. PIT,PIT,1,39,42,-3,2,0,-5,-3,29,29,0,6,0,-6,2
Winnipeg Jets,2015/01/27  vs. PIT,PIT,1,40,41,-1,5,-2,-4,-1,28,28,0,0,1,-1,1
Winnipeg Jets,2014/10/11  vs. SJS,SJS,1,40,34,6,-2,0,8,-4,28,27,1,0,0,1,-2
Winnipeg Jets,2015/01/05  vs. SJS,SJS,1,35,42,-7,-4,0,-3,-7,24,32,-8,-6,0,-2,-8
Winnipeg Jets,2015/03/17  vs. SJS,SJS,1,39,59,-20,1,-21,0,1,28,43,-15,0,-15,0,2
Winnipeg Jets,2014/11/23  vs. STL,STL,1,46,36,10,9,-3,4,6,34,27,7,6,0,1,6
Winnipeg Jets,2015/02/26  vs. STL,STL,1,55,38,17,14,0,3,15,35,26,9,7,0,2,8
Winnipeg Jets,2015/03/10  vs. STL,STL,1,30,30,0,-2,2,0,3,21,22,-1,0,1,-2,1
Winnipeg Jets,2015/03/19  vs. STL,STL,1,51,37,14,10,0,4,19,35,29,6,6,0,0,12
Winnipeg Jets,2015/04/07  vs. STL,STL,1,47,46,1,6,-5,0,15,38,37,1,5,-4,0,13
Winnipeg Jets,2014/10/24  vs. TBL,TBL,1,38,41,-3,-1,0,-2,4,29,33,-4,-2,0,-2,1
Winnipeg Jets,2015/03/14  vs. TBL,TBL,1,37,28,9,7,1,1,7,28,16,12,11,0,1,11
Winnipeg Jets,2015/01/03  vs. TOR,TOR,1,59,21,38,19,19,0,23,48,16,32,14,18,0,17
Winnipeg Jets,2015/02/21  vs. TOR,TOR,1,38,42,-4,-6,2,0,-1,29,31,-2,-3,1,0,-1
Winnipeg Jets,2015/02/03  vs. VAN,VAN,1,38,36,2,-3,5,0,0,28,26,2,-1,3,0,1
Winnipeg Jets,2015/03/24  vs. VAN,VAN,1,43,38,5,-3,4,4,-2,29,28,1,-3,5,-1,-1
Winnipeg Jets,2015/04/04  vs. VAN,VAN,1,52,38,14,3,11,0,6,41,30,11,3,8,0,6
Winnipeg Jets,2015/02/19  vs. WSH,WSH,1,39,32,7,9,0,-2,4,22,26,-4,4,0,-8,0
Winnipeg Jets,2015/03/21  vs. WSH,WSH,1,38,55,-17,-2,-15,0,-1,25,35,-10,3,-13,0,1
