Team,Game,Opp Team,GP,SAT For,SAT Agst,SAT,SAT Tied,SAT Ahead,SAT Behind,SAT Close,USAT For,USAT Agst,USAT,USAT Tied,USAT Ahead,USAT Behind,USAT Close
Pittsburgh Penguins,2014/03/07  vs. ANA,ANA,1,37,51,-14,-10,0,-4,-11,19,36,-17,-13,0,-4,-16
Phoenix Coyotes,2013/12/28  vs. ANA,ANA,1,45,45,0,-6,0,6,-3,32,37,-5,-6,0,1,-4
Philadelphia Flyers,2013/12/12  vs. MTL,MTL,1,48,39,9,11,-2,0,12,30,26,4,4,0,0,2
Ottawa Senators,2013/11/24  vs. CAR,CAR,1,59,66,-7,0,-16,9,-15,48,47,1,1,-10,10,-7
Minnesota Wild,2014/01/18  vs. DAL,DAL,1,27,50,-23,-9,-14,0,-21,17,37,-20,-7,-13,0,-18
Phoenix Coyotes,2013/10/18  vs. ANA,ANA,1,34,44,-10,-2,-6,-2,-4,27,29,-2,0,-1,-1,-1
Los Angeles Kings,2014/03/10  vs. CGY,CGY,1,47,44,3,-5,8,0,-3,32,29,3,-3,6,0,-1
Los Angeles Kings,2014/03/09  vs. EDM,EDM,1,64,47,17,7,10,0,15,51,33,18,4,14,0,10
Dallas Stars,2013/12/21  vs. SJS,SJS,1,60,45,15,-1,16,0,17,50,35,15,2,13,0,15
Phoenix Coyotes,2013/11/12  vs. STL,STL,1,30,61,-31,-15,-15,-1,-27,20,46,-26,-12,-13,-1,-22
Colorado Avalanche,2014/01/08  vs. OTT,OTT,1,52,53,-1,2,-15,12,-10,40,38,2,1,-6,7,-3
Florida Panthers,2013/12/10  vs. DET,DET,1,42,37,5,5,0,0,3,31,22,9,7,0,2,10
Columbus Blue Jackets,2013/10/25  vs. TOR,TOR,1,33,26,7,-2,9,0,3,27,21,6,-4,10,0,1
Chicago Blackhawks,2014/03/21  vs. CAR,CAR,1,29,20,9,7,2,0,9,20,16,4,8,-4,0,6
Edmonton Oilers,2013/11/21  vs. FLA,FLA,1,39,43,-4,-1,-3,0,5,33,29,4,-1,5,0,4
Nashville Predators,2013/10/17  vs. LAK,LAK,1,49,36,13,12,1,0,13,36,24,12,10,2,0,12
Florida Panthers,2014/03/23  vs. ANA,ANA,1,47,60,-13,0,0,-13,-1,39,53,-14,0,0,-14,1
Nashville Predators,2013/11/27  vs. CBJ,CBJ,1,35,36,-1,5,-6,0,6,26,25,1,4,-3,0,5
Boston Bruins,2014/03/15  vs. CAR,CAR,1,55,41,14,15,-1,0,13,44,30,14,10,4,0,10
Los Angeles Kings,2014/03/13  vs. TOR,TOR,1,64,32,32,22,-3,13,20,49,27,22,17,-1,6,17
Minnesota Wild,2014/01/16  vs. EDM,EDM,1,49,35,14,2,12,0,14,39,25,14,-1,15,0,11
Los Angeles Kings,2014/04/02  vs. PHX,PHX,1,42,36,6,-1,7,0,0,33,26,7,-1,8,0,0
New Jersey Devils,2014/03/08  vs. CAR,CAR,1,41,45,-4,-3,-1,0,0,31,36,-5,-1,-4,0,1
Washington Capitals,2014/02/27  vs. FLA,FLA,1,32,40,-8,1,-9,0,-1,27,32,-5,3,-8,0,0
Winnipeg Jets,2014/03/12  vs. VAN,VAN,1,43,42,1,-1,2,0,-2,32,31,1,2,-1,0,-1
St. Louis Blues,2013/10/26  vs. NSH,NSH,1,48,37,11,3,8,0,3,41,28,13,1,12,0,4
St. Louis Blues,2014/02/06  vs. BOS,BOS,1,30,44,-14,-6,-8,0,-6,25,34,-9,-3,-6,0,-3
Washington Capitals,2014/03/25  vs. LAK,LAK,1,24,51,-27,-5,-20,-2,-13,19,39,-20,-5,-12,-3,-9
New York Rangers,2014/01/08  vs. CHI,CHI,1,36,45,-9,6,-15,0,5,27,36,-9,0,-9,0,1
Anaheim Ducks,2013/10/22  vs. TOR,TOR,1,49,34,15,6,6,3,7,34,23,11,4,4,3,7
Montreal Canadiens,2014/03/08  vs. SJS,SJS,1,32,46,-14,1,0,-15,-3,22,38,-16,0,0,-16,-4
Phoenix Coyotes,2014/04/01  vs. WPG,WPG,1,54,39,15,18,0,-3,15,42,27,15,15,0,0,15
Buffalo Sabres,2013/10/02  vs. DET,DET,1,20,43,-23,-6,0,-17,-7,14,36,-22,-5,0,-17,-6
New York Islanders,2014/01/29  vs. NYR,NYR,1,45,48,-3,0,0,-3,0,33,39,-6,-1,0,-5,-1
Vancouver Canucks,2014/01/04  vs. LAK,LAK,1,33,63,-30,-7,-21,-2,-28,26,52,-26,-6,-19,-1,-24
Colorado Avalanche,2013/12/27  vs. CHI,CHI,1,27,57,-30,-3,0,-27,-5,20,47,-27,-5,0,-22,-8
San Jose Sharks,2014/02/28  vs. BUF,BUF,1,58,34,24,9,0,15,24,45,24,21,8,0,13,20
Chicago Blackhawks,2014/03/30  vs. PIT,PIT,1,62,36,26,1,0,25,11,47,25,22,0,0,22,6
New York Islanders,2013/10/29  vs. NYR,NYR,1,45,29,16,12,0,4,12,31,22,9,4,0,5,6
Montreal Canadiens,2013/10/22  vs. EDM,EDM,1,61,42,19,11,8,0,14,34,26,8,4,3,1,3
Anaheim Ducks,2013/12/07  vs. STL,STL,1,26,47,-21,1,-22,0,0,22,35,-13,1,-14,0,1
Minnesota Wild,2013/12/19  vs. PIT,PIT,1,38,48,-10,-1,0,-9,-7,30,37,-7,-1,0,-6,-3
St. Louis Blues,2013/12/31  vs. MIN,MIN,1,46,52,-6,-1,-5,0,-1,33,29,4,4,0,0,3
Florida Panthers,2013/12/05  vs. WPG,WPG,1,42,48,-6,3,-6,-3,-3,30,38,-8,1,-5,-4,-7
Ottawa Senators,2014/02/01  vs. TOR,TOR,1,50,43,7,13,-9,3,4,36,34,2,10,-8,0,2
Los Angeles Kings,2013/11/21  vs. NJD,NJD,1,52,30,22,24,0,-2,24,37,22,15,17,0,-2,17
Minnesota Wild,2013/10/03  vs. LAK,LAK,1,30,35,-5,5,-10,0,3,21,18,3,2,1,0,8
Anaheim Ducks,2013/11/22  vs. TBL,TBL,1,45,38,7,7,0,0,7,35,31,4,4,0,0,4
New York Islanders,2014/01/18  vs. PHI,PHI,1,38,52,-14,-6,-8,0,1,26,35,-9,2,-6,-5,5
Colorado Avalanche,2014/03/29  vs. SJS,SJS,1,26,66,-40,4,-44,0,-24,23,47,-24,6,-30,0,-16
Anaheim Ducks,2013/11/14  vs. TBL,TBL,1,31,40,-9,-9,0,0,-8,22,31,-9,-5,0,-4,-6
Winnipeg Jets,2013/10/29  vs. STL,STL,1,30,44,-14,-11,0,-3,-13,24,34,-10,-7,0,-3,-9
New York Rangers,2013/10/16  vs. WSH,WSH,1,49,40,9,8,1,0,11,39,25,14,10,4,0,11
Boston Bruins,2013/12/31  vs. NYI,NYI,1,45,41,4,1,4,-1,9,34,26,8,3,6,-1,10
Calgary Flames,2013/10/19  vs. SJS,SJS,1,28,44,-16,0,0,-16,1,17,25,-8,0,0,-8,0
Ottawa Senators,2013/12/16  vs. STL,STL,1,53,44,9,-5,16,-2,11,39,34,5,-6,13,-2,7
Colorado Avalanche,2014/02/01  vs. BUF,BUF,1,43,37,6,-4,10,0,-3,36,26,10,-4,14,0,-3
Dallas Stars,2014/02/08  vs. PHX,PHX,1,54,31,23,1,22,0,18,40,24,16,0,16,0,12
Colorado Avalanche,2013/12/12  vs. WPG,WPG,1,48,45,3,6,-7,4,12,26,32,-6,0,-7,1,3
Los Angeles Kings,2014/01/30  vs. PIT,PIT,1,50,30,20,-3,0,23,1,38,25,13,-2,0,15,0
New York Rangers,2013/11/30  vs. VAN,VAN,1,44,53,-9,-1,-8,0,-3,29,42,-13,-1,-12,0,-4
Montreal Canadiens,2014/04/01  vs. TBL,TBL,1,35,40,-5,-11,5,1,-6,31,29,2,-5,6,1,1
Los Angeles Kings,2013/11/30  vs. CGY,CGY,1,42,28,14,9,0,5,9,26,22,4,2,0,2,2
Florida Panthers,2013/11/19  vs. VAN,VAN,1,39,43,-4,5,-8,-1,-3,28,33,-5,4,-8,-1,-4
Chicago Blackhawks,2014/03/28  vs. OTT,OTT,1,52,48,4,1,0,3,-4,42,33,9,4,0,5,3
Pittsburgh Penguins,2013/12/23  vs. OTT,OTT,1,35,48,-13,-3,0,-10,-1,25,37,-12,-2,0,-10,1
New York Islanders,2013/12/20  vs. NYR,NYR,1,26,33,-7,-8,-1,2,-6,20,22,-2,-4,0,2,-1
New York Islanders,2014/01/06  vs. DAL,DAL,1,47,24,23,3,4,16,13,35,19,16,1,0,15,8
St. Louis Blues,2014/03/09  vs. MIN,MIN,1,32,38,-6,6,-12,0,-3,24,31,-7,3,-10,0,-4
Calgary Flames,2013/10/21  vs. LAK,LAK,1,34,48,-14,-15,0,1,-14,26,35,-9,-10,0,1,-9
New York Islanders,2013/10/04  vs. NJD,NJD,1,32,45,-13,-7,1,-7,-14,25,35,-10,-5,1,-6,-11
Los Angeles Kings,2014/01/11  vs. DET,DET,1,58,30,28,20,1,7,21,52,26,26,20,0,6,20
Boston Bruins,2014/01/19  vs. CHI,CHI,1,49,48,1,2,3,-4,1,36,37,-1,-2,4,-3,-1
Florida Panthers,2014/02/04  vs. TOR,TOR,1,67,39,28,15,13,0,30,57,26,31,17,14,0,31
Ottawa Senators,2014/01/30  vs. TBL,TBL,1,44,45,-1,-3,2,0,9,31,33,-2,-3,1,0,6
Boston Bruins,2013/11/11  vs. TBL,TBL,1,39,48,-9,2,-11,0,3,35,39,-4,2,-6,0,3
Columbus Blue Jackets,2014/04/06  vs. NYI,NYI,1,33,41,-8,4,-12,0,-2,28,32,-4,4,-8,0,1
Ottawa Senators,2013/12/01  vs. DET,DET,1,51,33,18,5,0,13,12,38,23,15,5,0,10,8
New York Islanders,2013/10/19  vs. CAR,CAR,1,36,42,-6,-6,0,0,-6,23,30,-7,-5,0,-2,-6
Minnesota Wild,2013/12/17  vs. VAN,VAN,1,41,39,2,1,0,1,0,29,32,-3,-1,0,-2,-4
Colorado Avalanche,2014/01/10  vs. NYI,NYI,1,47,28,19,22,-3,0,22,33,21,12,14,-2,0,14
Anaheim Ducks,2013/12/17  vs. DET,DET,1,37,30,7,3,5,-1,6,27,24,3,3,1,-1,4
Calgary Flames,2014/03/28  vs. NYR,NYR,1,35,68,-33,-7,-28,2,-15,30,51,-21,-8,-16,3,-12
Montreal Canadiens,2014/03/24  vs. BOS,BOS,1,20,38,-18,2,-20,0,-19,13,28,-15,-1,-14,0,-17
Carolina Hurricanes,2014/03/08  vs. NJD,NJD,1,45,41,4,3,0,1,0,36,31,5,1,0,4,-1
Tampa Bay Lightning,2014/03/22  vs. PIT,PIT,1,30,30,0,1,1,-2,-1,24,22,2,0,1,1,1
Washington Capitals,2013/12/23  vs. ANA,ANA,1,40,36,4,2,0,2,-1,27,28,-1,0,-1,0,-2
Detroit Red Wings,2013/12/19  vs. CGY,CGY,1,49,25,24,22,2,0,24,37,19,18,15,3,0,18
Phoenix Coyotes,2013/10/11  vs. PHI,PHI,1,47,49,-2,2,-4,0,4,35,40,-5,0,-5,0,1
Detroit Red Wings,2014/02/27  vs. OTT,OTT,1,27,47,-20,-6,-14,0,-6,24,38,-14,-4,-10,0,-3
Florida Panthers,2013/10/25  vs. BUF,BUF,1,71,30,41,16,22,3,38,56,23,33,10,18,5,28
Philadelphia Flyers,2013/10/26  vs. NYI,NYI,1,57,47,10,-3,13,0,6,44,31,13,-1,14,0,6
New Jersey Devils,2013/11/02  vs. PHI,PHI,1,20,26,-6,0,0,-6,-1,14,22,-8,-1,0,-7,-3
Anaheim Ducks,2014/03/29  vs. VAN,VAN,1,33,48,-15,0,-15,0,2,25,36,-11,1,-12,0,0
Detroit Red Wings,2013/10/23  vs. OTT,OTT,1,45,45,0,3,0,-3,1,34,37,-3,3,0,-6,1
Dallas Stars,2013/12/01  vs. EDM,EDM,1,49,39,10,4,6,0,2,35,27,8,3,5,0,2
New Jersey Devils,2013/10/24  vs. VAN,VAN,1,39,27,12,16,-4,0,12,34,24,10,15,-5,0,10
Anaheim Ducks,2014/01/15  vs. VAN,VAN,1,42,55,-13,-6,-7,0,-10,31,43,-12,-4,-8,0,-10
Calgary Flames,2014/04/07  vs. NJD,NJD,1,26,44,-18,-13,-5,0,-13,23,33,-10,-8,-2,0,-8
New Jersey Devils,2013/12/27  vs. CBJ,CBJ,1,23,26,-3,2,0,-5,-3,19,22,-3,2,0,-5,-3
Montreal Canadiens,2014/01/16  vs. OTT,OTT,1,38,64,-26,3,-35,6,-31,30,51,-21,0,-27,6,-25
Florida Panthers,2014/01/18  vs. CAR,CAR,1,44,52,-8,-1,0,-7,-2,37,37,0,5,0,-5,4
Toronto Maple Leafs,2014/01/09  vs. CAR,CAR,1,58,44,14,1,0,13,0,39,36,3,0,0,3,-1
Pittsburgh Penguins,2013/10/25  vs. NYI,NYI,1,45,57,-12,-8,-1,-3,-8,36,34,2,-5,8,-1,3
Anaheim Ducks,2013/11/10  vs. VAN,VAN,1,45,55,-10,-11,1,0,-6,28,42,-14,-14,0,0,-10
Phoenix Coyotes,2014/03/13  vs. BOS,BOS,1,33,37,-4,1,0,-5,-3,21,28,-7,0,0,-7,-2
Los Angeles Kings,2014/01/07  vs. MIN,MIN,1,64,29,35,34,1,0,34,49,20,29,28,1,0,28
Philadelphia Flyers,2014/02/03  vs. SJS,SJS,1,55,33,22,5,-4,21,25,38,19,19,7,-3,15,20
Calgary Flames,2013/12/27  vs. EDM,EDM,1,44,34,10,2,0,8,10,32,28,4,2,0,2,4
Edmonton Oilers,2013/12/21  vs. STL,STL,1,43,41,2,15,0,-13,10,26,28,-2,11,0,-13,8
Buffalo Sabres,2014/03/15  vs. NYI,NYI,1,42,54,-12,0,0,-12,-3,29,40,-11,0,0,-11,-4
Buffalo Sabres,2014/03/03  vs. DAL,DAL,1,40,54,-14,-12,3,-5,-9,32,41,-9,-7,2,-4,-5
Calgary Flames,2013/11/07  vs. STL,STL,1,33,38,-5,0,0,-5,-5,19,29,-10,0,0,-10,-4
Minnesota Wild,2014/01/11  vs. COL,COL,1,48,28,20,15,0,5,18,34,22,12,8,0,4,10
New Jersey Devils,2014/02/03  vs. COL,COL,1,36,25,11,-1,12,0,9,32,22,10,-1,11,0,6
New York Rangers,2014/04/01  vs. VAN,VAN,1,38,51,-13,-2,-11,0,-3,29,40,-11,-2,-9,0,-4
Boston Bruins,2013/11/15  vs. OTT,OTT,1,52,45,7,3,12,-8,11,41,34,7,3,11,-7,11
Vancouver Canucks,2013/11/30  vs. NYR,NYR,1,53,44,9,1,0,8,3,42,29,13,1,0,12,4
Chicago Blackhawks,2014/04/04  vs. CBJ,CBJ,1,48,38,10,11,5,-6,9,39,24,15,10,5,0,14
Los Angeles Kings,2013/12/11  vs. TOR,TOR,1,46,56,-10,-3,-7,0,-13,30,40,-10,-6,-4,0,-12
Detroit Red Wings,2014/01/01  vs. TOR,TOR,1,43,30,13,5,2,6,7,36,25,11,4,3,4,7
Winnipeg Jets,2013/11/23  vs. MIN,MIN,1,60,55,5,6,-1,0,7,49,43,6,6,0,0,8
Los Angeles Kings,2014/04/10  vs. EDM,EDM,1,61,37,24,0,24,0,5,45,25,20,0,20,0,4
Calgary Flames,2014/03/26  vs. ANA,ANA,1,59,54,5,8,-1,-2,3,44,37,7,9,0,-2,7
Calgary Flames,2013/11/20  vs. CBJ,CBJ,1,43,39,4,-5,0,9,-4,32,19,13,2,0,11,7
Pittsburgh Penguins,2013/12/18  vs. NYR,NYR,1,36,39,-3,1,-4,0,1,28,26,2,4,-2,0,4
Washington Capitals,2013/10/26  vs. CGY,CGY,1,42,33,9,-3,0,12,-2,29,29,0,-2,0,2,-5
San Jose Sharks,2013/11/21  vs. TBL,TBL,1,56,60,-4,2,-6,0,6,47,48,-1,2,-3,0,6
Philadelphia Flyers,2014/03/02  vs. WSH,WSH,1,42,33,9,3,0,6,3,29,24,5,0,0,5,2
Florida Panthers,2014/03/25  vs. OTT,OTT,1,59,55,4,-3,0,7,3,50,47,3,-5,0,8,2
St. Louis Blues,2014/01/09  vs. CGY,CGY,1,35,37,-2,2,-4,0,7,25,24,1,0,1,0,4
San Jose Sharks,2014/01/16  vs. FLA,FLA,1,47,35,12,10,2,0,11,43,27,16,9,7,0,11
Washington Capitals,2013/11/20  vs. PIT,PIT,1,29,50,-21,-6,0,-15,-14,16,40,-24,-6,0,-18,-12
New York Islanders,2013/12/12  vs. PHX,PHX,1,44,47,-3,-1,1,-3,-2,31,27,4,0,1,3,3
Washington Capitals,2013/12/08  vs. NYR,NYR,1,47,43,4,0,4,0,1,38,30,8,1,7,0,2
Anaheim Ducks,2013/10/24  vs. MTL,MTL,1,50,33,17,-7,0,24,-4,37,24,13,-3,0,16,-1
Nashville Predators,2014/03/04  vs. PIT,PIT,1,37,32,5,2,0,3,2,24,20,4,0,0,4,0
Toronto Maple Leafs,2013/10/08  vs. COL,COL,1,53,47,6,8,-5,3,3,38,38,0,4,-4,0,0
Boston Bruins,2014/01/04  vs. WPG,WPG,1,51,56,-5,5,-12,2,6,40,44,-4,6,-11,1,6
Dallas Stars,2013/12/16  vs. COL,COL,1,42,52,-10,-1,0,-9,-5,29,42,-13,-1,0,-12,-5
Philadelphia Flyers,2014/02/27  vs. SJS,SJS,1,36,43,-7,-1,7,-13,-1,29,34,-5,1,4,-10,0
Edmonton Oilers,2013/12/15  vs. ANA,ANA,1,34,57,-23,-7,3,-19,-10,28,43,-15,-6,4,-13,-7
Nashville Predators,2013/10/08  vs. MIN,MIN,1,25,44,-19,-1,-18,0,-12,22,34,-12,-1,-11,0,-8
New Jersey Devils,2013/10/07  vs. EDM,EDM,1,36,36,0,-1,5,-4,1,27,24,3,-1,7,-3,3
Calgary Flames,2014/01/30  vs. SJS,SJS,1,47,45,2,6,-4,0,2,36,34,2,2,0,0,-2
Toronto Maple Leafs,2013/12/03  vs. SJS,SJS,1,35,71,-36,-17,0,-19,-27,27,54,-27,-15,0,-12,-19
Dallas Stars,2014/01/27  vs. COL,COL,1,51,37,14,6,0,8,8,37,25,12,5,0,7,5
New Jersey Devils,2013/12/13  vs. PIT,PIT,1,71,40,31,-1,0,32,12,44,33,11,-1,0,12,2
Colorado Avalanche,2014/03/08  vs. STL,STL,1,44,46,-2,4,0,-6,-4,30,32,-2,0,0,-2,-4
Boston Bruins,2013/10/30  vs. PIT,PIT,1,40,52,-12,-3,0,-9,-4,25,42,-17,-8,0,-9,-11
Buffalo Sabres,2013/10/23  vs. BOS,BOS,1,29,34,-5,-1,0,-4,-5,21,24,-3,-1,0,-2,-4
San Jose Sharks,2014/04/09  vs. ANA,ANA,1,46,48,-2,-10,1,7,-11,36,38,-2,-9,1,6,-9
Phoenix Coyotes,2013/12/23  vs. BUF,BUF,1,39,37,2,5,-3,0,0,29,29,0,5,-5,0,-2
Nashville Predators,2014/04/13  vs. MIN,MIN,1,36,44,-8,5,-11,-2,2,31,33,-2,5,-5,-2,1
St. Louis Blues,2013/10/18  vs. WPG,WPG,1,51,55,-4,-10,6,0,1,36,40,-4,-7,3,0,0
Vancouver Canucks,2013/10/19  vs. PIT,PIT,1,54,40,14,9,5,0,14,40,27,13,9,4,0,13
Ottawa Senators,2013/11/19  vs. PHI,PHI,1,30,54,-24,-10,0,-14,-15,21,39,-18,-8,0,-10,-8
Detroit Red Wings,2013/10/05  vs. BOS,BOS,1,42,45,-3,1,0,-4,-4,31,38,-7,-2,0,-5,-6
Boston Bruins,2013/12/10  vs. CGY,CGY,1,50,36,14,8,-2,8,0,33,26,7,8,0,-1,-1
Nashville Predators,2014/01/23  vs. VAN,VAN,1,35,44,-9,0,-2,-7,-4,26,31,-5,-1,-2,-2,-1
Nashville Predators,2014/02/27  vs. TBL,TBL,1,39,27,12,5,4,3,3,29,19,10,8,3,-1,7
Winnipeg Jets,2014/01/18  vs. EDM,EDM,1,48,32,16,8,4,4,14,37,22,15,8,3,4,12
New York Islanders,2014/01/21  vs. NYR,NYR,1,48,43,5,-4,-2,11,6,40,37,3,-5,0,8,2
Philadelphia Flyers,2013/10/12  vs. DET,DET,1,44,27,17,2,0,15,8,35,20,15,0,0,15,8
Florida Panthers,2014/01/14  vs. NYI,NYI,1,34,46,-12,0,-12,0,1,27,36,-9,0,-9,0,3
Edmonton Oilers,2014/03/09  vs. LAK,LAK,1,47,64,-17,-7,0,-10,-15,33,51,-18,-4,0,-14,-10
Florida Panthers,2014/03/31  vs. NJD,NJD,1,27,33,-6,-1,0,-5,-3,18,29,-11,-1,0,-10,-7
Los Angeles Kings,2014/01/21  vs. CBJ,CBJ,1,39,37,2,-2,0,4,-8,25,30,-5,-2,0,-3,-7
Chicago Blackhawks,2014/03/19  vs. STL,STL,1,45,38,7,4,3,0,8,37,28,9,5,4,0,9
Buffalo Sabres,2014/02/25  vs. CAR,CAR,1,24,48,-24,-24,0,0,-27,19,37,-18,-18,0,0,-21
Dallas Stars,2013/10/15  vs. COL,COL,1,41,38,3,-1,-2,6,6,34,26,8,1,0,7,10
Philadelphia Flyers,2013/11/21  vs. BUF,BUF,1,44,32,12,3,-2,11,14,36,23,13,3,1,9,13
Dallas Stars,2013/10/05  vs. WSH,WSH,1,45,40,5,2,1,2,5,37,28,9,2,6,1,6
Minnesota Wild,2014/01/28  vs. ANA,ANA,1,30,39,-9,-8,-1,0,-3,27,33,-6,-6,0,0,-1
Carolina Hurricanes,2014/03/16  vs. EDM,EDM,1,52,46,6,1,0,5,3,37,38,-1,-2,0,1,-3
San Jose Sharks,2014/03/04  vs. CAR,CAR,1,68,54,14,16,-1,-1,14,52,40,12,12,1,-1,12
Phoenix Coyotes,2014/01/04  vs. PHI,PHI,1,49,36,13,13,-1,1,14,37,29,8,8,-1,1,11
Vancouver Canucks,2013/10/22  vs. NYI,NYI,1,58,52,6,-4,5,5,2,41,37,4,-2,2,4,3
Carolina Hurricanes,2014/04/08  vs. NYR,NYR,1,52,60,-8,-5,0,-3,-4,36,41,-5,0,1,-6,2
Phoenix Coyotes,2014/03/25  vs. PIT,PIT,1,41,45,-4,-5,1,0,1,32,28,4,-2,6,0,6
Anaheim Ducks,2013/10/29  vs. PHI,PHI,1,54,40,14,11,5,-2,6,42,30,12,14,4,-6,10
Vancouver Canucks,2013/10/08  vs. NJD,NJD,1,47,32,15,8,0,7,15,35,30,5,1,0,4,5
Toronto Maple Leafs,2014/03/08  vs. PHI,PHI,1,52,68,-16,-5,-11,0,-4,42,44,-2,-2,0,0,0
Carolina Hurricanes,2014/03/15  vs. BOS,BOS,1,41,55,-14,-15,0,1,-13,30,44,-14,-10,0,-4,-10
New York Rangers,2014/04/10  vs. BUF,BUF,1,47,29,18,5,0,13,18,32,23,9,-3,0,12,9
Philadelphia Flyers,2014/01/30  vs. ANA,ANA,1,46,49,-3,2,0,-5,-1,33,41,-8,0,0,-8,-5
Phoenix Coyotes,2014/04/08  vs. CBJ,CBJ,1,46,50,-4,-5,2,-1,-1,33,33,0,-5,4,1,1
Ottawa Senators,2014/04/02  vs. NYI,NYI,1,64,40,24,-3,0,27,8,42,30,12,-4,0,16,2
Chicago Blackhawks,2013/11/23  vs. VAN,VAN,1,41,51,-10,12,-17,-5,7,33,40,-7,8,-13,-2,5
Chicago Blackhawks,2013/12/05  vs. MIN,MIN,1,35,33,2,0,-8,10,7,22,23,-1,0,-6,5,3
Montreal Canadiens,2014/01/25  vs. WSH,WSH,1,40,41,-1,-3,0,2,-7,24,28,-4,-2,0,-2,-5
Tampa Bay Lightning,2014/01/23  vs. OTT,OTT,1,39,65,-26,-3,-23,0,-7,36,43,-7,7,-14,0,7
Minnesota Wild,2013/11/09  vs. CAR,CAR,1,47,46,1,-2,2,1,1,30,36,-6,-6,1,-1,-6
Toronto Maple Leafs,2013/12/12  vs. STL,STL,1,28,46,-18,-1,0,-17,-10,20,42,-22,-1,0,-21,-11
Anaheim Ducks,2014/02/01  vs. DAL,DAL,1,39,42,-3,-1,0,-2,-13,29,35,-6,-2,0,-4,-11
Buffalo Sabres,2014/03/16  vs. MTL,MTL,1,38,44,-6,-4,0,-2,-6,30,37,-7,-5,0,-2,-7
St. Louis Blues,2013/11/19  vs. BUF,BUF,1,49,44,5,6,-3,2,8,36,31,5,6,-3,2,7
New York Rangers,2013/10/28  vs. MTL,MTL,1,39,33,6,7,0,-1,11,25,24,1,4,0,-3,7
Nashville Predators,2014/01/04  vs. FLA,FLA,1,41,44,-3,-7,3,1,-4,36,38,-2,-5,2,1,-3
Detroit Red Wings,2014/04/13  vs. STL,STL,1,36,37,-1,-1,0,0,3,29,26,3,0,3,0,5
Dallas Stars,2014/01/23  vs. TOR,TOR,1,43,41,2,7,-5,0,8,33,30,3,2,1,0,5
New York Islanders,2014/04/06  vs. CBJ,CBJ,1,41,33,8,-4,0,12,2,32,28,4,-4,0,8,-1
Los Angeles Kings,2013/12/07  vs. NYI,NYI,1,35,23,12,-2,14,0,3,23,17,6,0,6,0,2
New Jersey Devils,2014/02/08  vs. WSH,WSH,1,51,41,10,5,0,5,5,33,27,6,4,0,2,4
San Jose Sharks,2013/12/31  vs. ANA,ANA,1,43,47,-4,-5,0,1,-13,33,37,-4,-2,0,-2,-9
Anaheim Ducks,2013/10/18  vs. PHX,PHX,1,44,34,10,2,2,6,4,29,27,2,0,1,1,1
Columbus Blue Jackets,2014/01/21  vs. LAK,LAK,1,37,39,-2,2,-4,0,8,30,25,5,2,3,0,7
Toronto Maple Leafs,2013/12/07  vs. OTT,OTT,1,35,52,-17,-3,-14,0,-4,31,45,-14,-1,-13,0,-2
Anaheim Ducks,2014/01/07  vs. BOS,BOS,1,34,54,-20,-15,-5,0,-14,24,43,-19,-16,-3,0,-16
Pittsburgh Penguins,2014/01/25  vs. DAL,DAL,1,39,40,-1,-11,0,10,-15,24,28,-4,-8,0,4,-10
Columbus Blue Jackets,2014/02/07  vs. SJS,SJS,1,30,58,-28,-4,0,-24,-15,21,49,-28,-4,0,-24,-15
Vancouver Canucks,2013/10/05  vs. EDM,EDM,1,37,28,9,9,0,0,11,25,19,6,7,-1,0,8
Colorado Avalanche,2014/01/30  vs. MIN,MIN,1,48,48,0,4,-4,0,6,43,38,5,7,-2,0,11
Minnesota Wild,2014/03/27  vs. STL,STL,1,35,30,5,2,0,3,-3,27,21,6,3,0,3,-1
Carolina Hurricanes,2013/10/11  vs. LAK,LAK,1,42,53,-11,-11,0,0,-11,27,45,-18,-18,0,0,-18
Anaheim Ducks,2014/01/28  vs. MIN,MIN,1,39,30,9,8,0,1,3,33,27,6,6,0,0,1
Anaheim Ducks,2014/04/04  vs. NSH,NSH,1,43,37,6,4,0,2,-1,30,30,0,4,0,-4,0
Carolina Hurricanes,2013/11/27  vs. NJD,NJD,1,31,42,-11,0,-11,0,-1,25,32,-7,1,-8,0,1
Philadelphia Flyers,2014/01/04  vs. PHX,PHX,1,36,49,-13,-13,-1,1,-14,29,37,-8,-8,-1,1,-11
Minnesota Wild,2014/03/20  vs. NJD,NJD,1,17,27,-10,-12,0,2,-16,15,23,-8,-12,0,4,-14
Edmonton Oilers,2014/03/22  vs. CGY,CGY,1,43,50,-7,2,-3,-6,-4,31,42,-11,1,-4,-8,-6
Buffalo Sabres,2014/03/27  vs. NSH,NSH,1,50,45,5,-1,0,6,-4,38,36,2,-1,0,3,-5
Vancouver Canucks,2014/01/29  vs. CHI,CHI,1,58,64,-6,-1,-1,-4,-1,32,52,-20,-2,-6,-12,-6
New York Islanders,2014/03/14  vs. SJS,SJS,1,52,45,7,4,0,3,11,41,36,5,2,0,3,8
St. Louis Blues,2014/01/14  vs. PHX,PHX,1,28,40,-12,-3,-9,0,-3,20,25,-5,1,-6,0,0
Boston Bruins,2014/04/08  vs. MIN,MIN,1,38,36,2,7,-6,1,8,21,28,-7,-4,-4,1,-3
Philadelphia Flyers,2013/10/06  vs. CAR,CAR,1,36,49,-13,-8,0,-5,-15,27,38,-11,-4,0,-7,-12
New York Islanders,2013/11/16  vs. DET,DET,1,44,34,10,8,4,-2,7,31,28,3,6,2,-5,2
San Jose Sharks,2014/03/06  vs. PIT,PIT,1,45,39,6,-3,-3,12,-3,35,22,13,0,0,13,0
Ottawa Senators,2013/10/09  vs. LAK,LAK,1,37,49,-12,-1,0,-11,-3,27,37,-10,-2,0,-8,-3
New York Islanders,2013/12/21  vs. ANA,ANA,1,36,52,-16,0,-14,-2,-10,27,32,-5,3,-7,-1,0
Florida Panthers,2014/04/10  vs. TOR,TOR,1,54,36,18,3,15,0,15,45,29,16,3,13,0,14
Buffalo Sabres,2014/02/28  vs. SJS,SJS,1,34,58,-24,-9,-15,0,-24,24,45,-21,-8,-13,0,-20
Toronto Maple Leafs,2013/12/27  vs. BUF,BUF,1,54,50,4,9,0,-5,7,41,41,0,10,-2,-8,8
Ottawa Senators,2014/03/05  vs. CGY,CGY,1,44,24,20,-2,0,22,8,32,22,10,-1,0,11,3
Toronto Maple Leafs,2013/11/08  vs. NJD,NJD,1,24,50,-26,-25,-1,0,-25,20,39,-19,-18,-1,0,-18
Montreal Canadiens,2014/02/04  vs. CGY,CGY,1,61,51,10,12,-2,0,16,41,34,7,5,2,0,10
Phoenix Coyotes,2013/10/15  vs. OTT,OTT,1,48,52,-4,-7,-3,6,-4,40,42,-2,-9,1,6,-3
Los Angeles Kings,2014/03/24  vs. PHI,PHI,1,54,45,9,10,-1,0,17,45,32,13,8,5,0,16
Montreal Canadiens,2014/04/05  vs. DET,DET,1,34,40,-6,2,-8,0,2,26,26,0,3,-3,0,3
Carolina Hurricanes,2013/12/05  vs. NSH,NSH,1,43,24,19,5,15,-1,18,24,20,4,1,4,-1,4
Calgary Flames,2013/10/11  vs. NJD,NJD,1,44,44,0,1,0,-1,0,36,29,7,7,0,0,7
Columbus Blue Jackets,2013/11/02  vs. PIT,PIT,1,27,27,0,-6,0,6,-7,17,22,-5,-7,0,2,-9
Philadelphia Flyers,2013/12/02  vs. MIN,MIN,1,45,34,11,7,0,4,7,31,28,3,1,0,2,1
Tampa Bay Lightning,2013/10/05  vs. CHI,CHI,1,34,48,-14,-8,0,-6,-14,17,39,-22,-13,0,-9,-17
Los Angeles Kings,2013/12/30  vs. CHI,CHI,1,44,36,8,5,0,3,20,33,28,5,1,0,4,15
Vancouver Canucks,2013/10/30  vs. DET,DET,1,34,51,-17,-7,-1,-9,-8,24,33,-9,-2,-1,-6,-3
Phoenix Coyotes,2013/12/27  vs. SJS,SJS,1,51,50,1,9,-10,2,-1,38,33,5,8,-4,1,4
Nashville Predators,2014/04/08  vs. DAL,DAL,1,59,49,10,10,0,0,13,41,35,6,2,0,4,7
Edmonton Oilers,2014/02/06  vs. NYR,NYR,1,46,60,-14,-13,-1,0,-15,39,48,-9,-7,-2,0,-10
St. Louis Blues,2014/01/20  vs. DET,DET,1,36,36,0,5,-5,0,4,28,26,2,4,-2,0,2
Carolina Hurricanes,2013/12/27  vs. PIT,PIT,1,63,45,18,6,11,1,17,46,37,9,4,4,1,8
Edmonton Oilers,2014/04/01  vs. SJS,SJS,1,31,37,-6,-3,-6,3,1,23,27,-4,-3,-3,2,-2
New Jersey Devils,2013/12/23  vs. CHI,CHI,1,30,50,-20,-7,0,-13,-13,19,40,-21,-5,0,-16,-12
Anaheim Ducks,2014/01/11  vs. PHX,PHX,1,37,53,-16,-4,-12,0,1,33,35,-2,3,-8,3,11
Los Angeles Kings,2013/11/12  vs. BUF,BUF,1,58,26,32,-3,31,4,28,44,18,26,-2,26,2,24
New York Rangers,2014/02/27  vs. CHI,CHI,1,33,45,-12,4,-16,0,4,29,29,0,3,-3,0,5
St. Louis Blues,2013/12/07  vs. ANA,ANA,1,47,26,21,-1,0,22,0,35,22,13,-1,0,14,-1
Florida Panthers,2013/11/01  vs. STL,STL,1,47,40,7,5,0,2,-5,35,30,5,4,0,1,-3
Ottawa Senators,2014/03/08  vs. WPG,WPG,1,36,45,-9,5,-14,0,2,30,39,-9,5,-14,0,1
Nashville Predators,2014/01/28  vs. WPG,WPG,1,37,46,-9,-4,-5,0,-4,31,32,-1,0,-1,0,3
Philadelphia Flyers,2013/12/17  vs. WSH,WSH,1,48,39,9,2,4,3,5,29,26,3,0,4,-1,-1
Edmonton Oilers,2014/02/27  vs. MIN,MIN,1,33,37,-4,0,0,-4,-6,22,26,-4,0,0,-4,-6
Florida Panthers,2013/12/17  vs. TOR,TOR,1,43,50,-7,-1,-6,0,-5,33,37,-4,0,-4,0,-2
Carolina Hurricanes,2014/01/23  vs. BUF,BUF,1,49,45,4,6,-2,0,7,38,40,-2,1,-1,-2,0
New Jersey Devils,2014/04/01  vs. BUF,BUF,1,54,31,23,12,10,1,21,35,22,13,3,9,1,11
Washington Capitals,2014/01/12  vs. BUF,BUF,1,49,39,10,10,0,0,10,34,26,8,9,-1,0,8
Calgary Flames,2013/12/21  vs. PIT,PIT,1,40,35,5,-3,0,8,-2,28,21,7,2,0,5,3
Anaheim Ducks,2014/04/06  vs. EDM,EDM,1,54,37,17,1,4,12,10,36,27,9,0,2,7,6
Calgary Flames,2014/04/09  vs. LAK,LAK,1,42,73,-31,-12,-19,0,-30,28,52,-24,-9,-15,0,-25
Dallas Stars,2014/04/05  vs. TBL,TBL,1,30,37,-7,0,-7,0,-3,26,32,-6,0,-6,0,-2
Phoenix Coyotes,2014/04/04  vs. EDM,EDM,1,43,43,0,-6,1,5,-1,32,31,1,-2,0,3,1
Nashville Predators,2013/10/04  vs. COL,COL,1,33,47,-14,1,0,-15,-1,25,39,-14,1,0,-15,-2
Nashville Predators,2013/10/31  vs. PHX,PHX,1,63,49,14,9,5,0,13,51,32,19,10,9,0,13
Toronto Maple Leafs,2014/02/04  vs. FLA,FLA,1,39,67,-28,-15,0,-13,-30,26,57,-31,-17,0,-14,-31
Dallas Stars,2014/01/12  vs. NYI,NYI,1,52,63,-11,2,-11,-2,-1,42,45,-3,2,-3,-2,4
Colorado Avalanche,2014/03/10  vs. WPG,WPG,1,37,49,-12,-3,-7,-2,-12,29,38,-9,-3,-4,-2,-9
San Jose Sharks,2014/03/08  vs. MTL,MTL,1,46,32,14,-1,15,0,3,38,22,16,0,16,0,4
Boston Bruins,2014/03/09  vs. FLA,FLA,1,50,30,20,16,2,2,18,39,21,18,14,3,1,15
Montreal Canadiens,2013/10/28  vs. NYR,NYR,1,33,39,-6,-7,1,0,-11,24,25,-1,-4,3,0,-7
Toronto Maple Leafs,2013/11/21  vs. NSH,NSH,1,38,40,-2,-1,0,-1,-1,33,29,4,3,0,1,3
Philadelphia Flyers,2014/01/02  vs. COL,COL,1,37,51,-14,-1,0,-13,-7,27,38,-11,-2,0,-9,-6
Philadelphia Flyers,2013/11/30  vs. NSH,NSH,1,26,47,-21,-22,0,1,-22,20,38,-18,-17,0,-1,-17
Ottawa Senators,2013/10/12  vs. SJS,SJS,1,33,53,-20,-8,-1,-11,-10,19,42,-23,-9,-3,-11,-15
Carolina Hurricanes,2014/04/11  vs. DET,DET,1,25,37,-12,-5,-7,0,-10,18,31,-13,-4,-9,0,-9
Phoenix Coyotes,2014/02/04  vs. DAL,DAL,1,56,45,11,1,0,10,1,40,35,5,0,1,4,1
Nashville Predators,2014/01/09  vs. ANA,ANA,1,28,45,-17,-3,-12,-2,-4,23,32,-9,0,-9,0,-2
Winnipeg Jets,2013/11/17  vs. MIN,MIN,1,39,47,-8,-4,0,-4,-5,26,35,-9,-4,0,-5,-6
Ottawa Senators,2013/10/05  vs. TOR,TOR,1,58,49,9,7,1,1,10,44,36,8,5,3,0,6
Los Angeles Kings,2013/12/23  vs. DAL,DAL,1,55,34,21,6,-3,18,10,43,25,18,5,-2,15,10
Buffalo Sabres,2014/01/23  vs. CAR,CAR,1,45,49,-4,-6,0,2,-7,40,38,2,-1,2,1,0
Carolina Hurricanes,2014/03/01  vs. LAK,LAK,1,32,39,-7,-8,0,1,-9,30,35,-5,-8,0,3,-9
Los Angeles Kings,2014/02/26  vs. COL,COL,1,37,38,-1,10,-13,2,9,27,28,-1,7,-10,2,8
Philadelphia Flyers,2013/12/09  vs. OTT,OTT,1,44,58,-14,-16,4,-2,-12,33,42,-9,-9,3,-3,-6
Dallas Stars,2013/12/05  vs. TOR,TOR,1,62,33,29,15,0,14,23,48,25,23,14,0,9,20
Calgary Flames,2014/03/21  vs. NSH,NSH,1,49,34,15,11,0,4,14,41,24,17,13,0,4,14
St. Louis Blues,2014/01/31  vs. CAR,CAR,1,42,53,-11,4,0,-15,-13,38,34,4,3,0,1,-2
Tampa Bay Lightning,2014/03/04  vs. STL,STL,1,30,46,-16,-7,-15,6,-12,23,31,-8,-4,-8,4,-6
Tampa Bay Lightning,2014/01/28  vs. TOR,TOR,1,53,47,6,0,0,6,11,43,34,9,5,0,4,13
Carolina Hurricanes,2013/12/29  vs. TOR,TOR,1,64,39,25,15,0,10,17,52,30,22,14,0,8,15
Detroit Red Wings,2013/10/30  vs. VAN,VAN,1,51,34,17,7,9,1,8,33,24,9,2,6,1,3
Philadelphia Flyers,2014/01/18  vs. NYI,NYI,1,52,38,14,6,0,8,-1,35,26,9,-2,5,6,-5
Montreal Canadiens,2013/12/17  vs. PHX,PHX,1,44,54,-10,6,-3,-13,-6,32,34,-2,7,0,-9,0
New Jersey Devils,2013/11/08  vs. TOR,TOR,1,50,24,26,25,0,1,25,39,20,19,18,0,1,18
St. Louis Blues,2013/11/16  vs. CAR,CAR,1,49,30,19,19,0,0,20,36,23,13,12,1,0,13
Los Angeles Kings,2014/01/27  vs. SJS,SJS,1,40,43,-3,13,-16,0,11,21,23,-2,7,-9,0,6
Washington Capitals,2014/01/04  vs. MIN,MIN,1,43,19,24,11,-3,16,19,27,12,15,8,0,7,11
Montreal Canadiens,2013/11/29  vs. WSH,WSH,1,42,45,-3,3,-6,0,-1,33,32,1,5,-4,0,2
Dallas Stars,2014/03/22  vs. OTT,OTT,1,57,42,15,5,4,6,11,42,32,10,4,3,3,7
Buffalo Sabres,2014/02/26  vs. BOS,BOS,1,20,43,-23,-8,-12,-3,-21,18,29,-11,-3,-7,-1,-11
Toronto Maple Leafs,2014/03/01  vs. MTL,MTL,1,38,43,-5,-8,1,2,-12,23,35,-12,-9,2,-5,-20
Anaheim Ducks,2013/12/03  vs. LAK,LAK,1,28,73,-45,-42,-3,0,-42,22,55,-33,-30,-3,0,-30
Pittsburgh Penguins,2014/03/01  vs. CHI,CHI,1,35,40,-5,-6,0,1,-9,24,35,-11,-6,0,-5,-10
Boston Bruins,2014/01/27  vs. NYI,NYI,1,55,51,4,2,2,0,2,39,30,9,1,8,0,6
New Jersey Devils,2014/01/04  vs. BUF,BUF,1,36,19,17,11,0,6,10,20,12,8,6,0,2,5
New York Islanders,2013/10/17  vs. EDM,EDM,1,43,30,13,-1,7,7,9,37,23,14,1,7,6,9
Vancouver Canucks,2014/02/06  vs. MTL,MTL,1,60,43,17,3,0,14,6,46,30,16,5,0,11,10
Philadelphia Flyers,2014/01/16  vs. NSH,NSH,1,43,43,0,5,6,-11,5,26,32,-6,4,3,-13,-1
New York Islanders,2014/04/13  vs. BUF,BUF,1,43,50,-7,-6,0,-1,-7,29,44,-15,-8,0,-7,-12
Ottawa Senators,2014/01/04  vs. MTL,MTL,1,47,38,9,4,5,0,6,34,31,3,4,-1,0,5
Colorado Avalanche,2014/03/19  vs. WPG,WPG,1,40,47,-7,-5,-3,1,-7,30,37,-7,-4,-1,-2,-6
St. Louis Blues,2013/12/17  vs. SJS,SJS,1,41,37,4,-1,0,5,-5,24,30,-6,0,0,-6,-3
New Jersey Devils,2013/10/11  vs. CGY,CGY,1,44,44,0,-1,1,0,0,29,36,-7,-7,0,0,-7
Buffalo Sabres,2013/12/31  vs. WPG,WPG,1,42,38,4,0,0,4,4,29,27,2,2,0,0,2
Tampa Bay Lightning,2013/11/21  vs. SJS,SJS,1,60,56,4,-2,0,6,-6,48,47,1,-2,0,3,-6
Nashville Predators,2014/01/05  vs. CAR,CAR,1,59,50,9,-2,0,11,6,46,34,12,-1,0,13,10
New York Islanders,2014/01/27  vs. BOS,BOS,1,51,55,-4,-2,0,-2,-2,30,39,-9,-1,0,-8,-6
Dallas Stars,2013/12/14  vs. WPG,WPG,1,40,48,-8,2,-10,0,-4,29,33,-4,1,-5,0,1
Toronto Maple Leafs,2013/10/05  vs. OTT,OTT,1,49,58,-9,-7,-1,-1,-10,36,44,-8,-5,0,-3,-6
Montreal Canadiens,2013/10/26  vs. SJS,SJS,1,33,58,-25,-7,0,-18,-11,24,44,-20,-7,0,-13,-7
Chicago Blackhawks,2014/04/06  vs. STL,STL,1,47,32,15,2,1,12,15,37,26,11,1,-1,11,13
New York Islanders,2013/10/12  vs. NSH,NSH,1,29,53,-24,-17,-3,-4,-17,17,38,-21,-11,-3,-7,-13
Los Angeles Kings,2014/03/20  vs. WSH,WSH,1,47,33,14,1,13,0,6,33,24,9,-1,10,0,2
Detroit Red Wings,2013/11/07  vs. DAL,DAL,1,39,32,7,5,2,0,2,34,27,7,4,3,0,2
Detroit Red Wings,2014/03/14  vs. EDM,EDM,1,46,36,10,-2,12,0,9,35,24,11,-1,12,0,11
Carolina Hurricanes,2014/01/27  vs. CBJ,CBJ,1,49,50,-1,-4,-3,6,-6,36,35,1,-1,-1,3,-2
Pittsburgh Penguins,2013/10/19  vs. VAN,VAN,1,40,54,-14,-9,0,-5,-14,27,40,-13,-9,0,-4,-13
Calgary Flames,2013/11/05  vs. MIN,MIN,1,34,32,2,0,-4,6,-2,28,20,8,3,-2,7,3
Pittsburgh Penguins,2014/01/30  vs. LAK,LAK,1,30,50,-20,3,-23,0,-1,25,38,-13,2,-15,0,0
Washington Capitals,2014/03/18  vs. ANA,ANA,1,44,53,-9,-6,-3,0,-2,33,44,-11,-8,-3,0,-4
Carolina Hurricanes,2014/02/04  vs. WPG,WPG,1,50,46,4,0,0,4,3,42,39,3,0,0,3,2
Washington Capitals,2013/10/19  vs. CBJ,CBJ,1,55,56,-1,6,-7,0,-4,43,46,-3,4,-7,0,-7
Montreal Canadiens,2013/10/19  vs. NSH,NSH,1,36,42,-6,-5,0,-1,-6,25,34,-9,-8,0,-1,-9
New Jersey Devils,2014/01/30  vs. DAL,DAL,1,34,30,4,0,4,0,-2,26,19,7,3,4,0,0
Chicago Blackhawks,2014/04/11  vs. WSH,WSH,1,59,45,14,0,0,14,4,44,38,6,0,0,6,3
Washington Capitals,2014/03/22  vs. SJS,SJS,1,44,46,-2,2,-1,-3,1,27,33,-6,-3,0,-3,-3
Los Angeles Kings,2013/10/29  vs. PHX,PHX,1,65,39,26,12,0,14,11,49,30,19,14,0,5,13
Pittsburgh Penguins,2014/03/18  vs. DAL,DAL,1,42,48,-6,0,-6,0,-1,34,35,-1,2,-3,0,0
Calgary Flames,2014/03/10  vs. LAK,LAK,1,44,47,-3,5,0,-8,3,29,32,-3,3,0,-6,1
Colorado Avalanche,2013/10/12  vs. WSH,WSH,1,34,62,-28,-4,-24,0,1,27,45,-18,-3,-15,0,-1
Boston Bruins,2014/03/06  vs. WSH,WSH,1,65,32,33,13,20,0,21,53,25,28,10,18,0,18
San Jose Sharks,2013/10/21  vs. DET,DET,1,28,43,-15,-15,0,0,-15,23,35,-12,-12,0,0,-12
Colorado Avalanche,2014/03/16  vs. OTT,OTT,1,36,64,-28,-13,-15,0,-15,28,46,-18,-10,-8,0,-12
Los Angeles Kings,2014/03/22  vs. FLA,FLA,1,48,33,15,2,13,0,3,37,26,11,1,10,0,1
Minnesota Wild,2014/01/04  vs. WSH,WSH,1,19,43,-24,-11,-16,3,-19,12,27,-15,-8,-7,0,-11
New York Rangers,2013/10/12  vs. STL,STL,1,29,49,-20,-9,0,-11,-8,23,37,-14,-8,0,-6,-4
Toronto Maple Leafs,2014/02/27  vs. NYI,NYI,1,36,37,-1,2,-2,-1,2,26,32,-6,-1,-4,-1,-3
New York Islanders,2013/11/14  vs. LAK,LAK,1,32,39,-7,-8,2,-1,-6,25,25,0,-1,2,-1,1
Tampa Bay Lightning,2014/04/13  vs. WSH,WSH,1,58,36,22,22,0,0,22,42,25,17,17,0,0,17
Anaheim Ducks,2013/10/05  vs. MIN,MIN,1,26,51,-25,-2,-23,0,-5,22,36,-14,0,-14,0,-1
Montreal Canadiens,2014/03/01  vs. TOR,TOR,1,43,38,5,8,-2,-1,12,35,23,12,9,5,-2,20
Phoenix Coyotes,2014/03/20  vs. FLA,FLA,1,38,37,1,2,-1,0,2,26,28,-2,1,-3,0,-1
Phoenix Coyotes,2014/02/01  vs. PIT,PIT,1,49,45,4,2,2,0,-2,32,29,3,0,3,0,1
Tampa Bay Lightning,2014/03/27  vs. NYI,NYI,1,44,40,4,0,3,1,2,32,29,3,2,1,0,1
Los Angeles Kings,2014/03/15  vs. ANA,ANA,1,54,33,21,11,0,10,14,40,29,11,4,0,7,7
New Jersey Devils,2014/02/07  vs. EDM,EDM,1,40,28,12,11,1,0,12,27,22,5,4,1,0,5
Phoenix Coyotes,2013/12/12  vs. NYI,NYI,1,47,44,3,1,3,-1,2,27,31,-4,0,-3,-1,-3
Vancouver Canucks,2013/12/08  vs. COL,COL,1,42,48,-6,-1,-5,0,2,27,35,-8,-2,-6,0,-3
Edmonton Oilers,2013/10/17  vs. NYI,NYI,1,30,43,-13,1,-7,-7,-9,23,37,-14,-1,-6,-7,-9
St. Louis Blues,2013/11/12  vs. PHX,PHX,1,61,30,31,15,1,15,27,46,20,26,12,1,13,22
New Jersey Devils,2013/11/27  vs. CAR,CAR,1,42,31,11,0,0,11,1,32,25,7,-1,0,8,-1
Detroit Red Wings,2014/03/25  vs. CBJ,CBJ,1,41,39,2,-4,0,6,2,32,29,3,-6,0,9,2
Carolina Hurricanes,2014/03/29  vs. CBJ,CBJ,1,49,47,2,-1,3,0,2,33,35,-2,-5,3,0,-2
Carolina Hurricanes,2013/11/23  vs. BOS,BOS,1,34,43,-9,-16,3,4,-14,27,32,-5,-11,3,3,-9
New Jersey Devils,2013/12/04  vs. MTL,MTL,1,49,35,14,4,1,9,12,37,31,6,1,2,3,5
New Jersey Devils,2014/03/31  vs. FLA,FLA,1,33,27,6,1,5,0,3,29,18,11,1,10,0,7
Montreal Canadiens,2013/10/15  vs. WPG,WPG,1,37,61,-24,8,-32,0,9,31,42,-11,5,-16,0,7
Minnesota Wild,2013/11/17  vs. WPG,WPG,1,47,39,8,4,4,0,5,35,26,9,4,5,0,6
Colorado Avalanche,2013/12/23  vs. SJS,SJS,1,50,67,-17,-16,-12,11,-27,31,47,-16,-12,-10,6,-24
Columbus Blue Jackets,2013/12/23  vs. CAR,CAR,1,39,40,-1,16,-7,-10,8,28,29,-1,11,-3,-9,6
San Jose Sharks,2014/03/27  vs. WPG,WPG,1,39,55,-16,-15,-2,1,-17,28,39,-11,-12,0,1,-12
Philadelphia Flyers,2013/11/02  vs. NJD,NJD,1,26,20,6,0,6,0,1,22,14,8,1,7,0,3
Detroit Red Wings,2014/03/09  vs. NYR,NYR,1,38,47,-9,-2,0,-7,-5,30,33,-3,-1,0,-2,-2
Winnipeg Jets,2014/01/28  vs. NSH,NSH,1,46,37,9,4,0,5,4,32,31,1,0,0,1,-3
Minnesota Wild,2013/11/07  vs. WSH,WSH,1,36,41,-5,-1,-6,2,-1,30,28,2,4,-5,3,4
Florida Panthers,2014/02/27  vs. WSH,WSH,1,40,32,8,-1,0,9,1,32,27,5,-3,0,8,0
Los Angeles Kings,2013/10/07  vs. NYR,NYR,1,44,45,-1,6,0,-7,6,33,35,-2,3,0,-5,1
Phoenix Coyotes,2014/02/27  vs. WPG,WPG,1,33,37,-4,-5,-1,2,-1,25,28,-3,-5,0,2,-1
Winnipeg Jets,2014/01/13  vs. PHX,PHX,1,41,33,8,-3,9,2,9,35,20,15,2,11,2,13
San Jose Sharks,2013/12/06  vs. CAR,CAR,1,51,61,-10,2,-12,0,-4,30,43,-13,3,-12,-4,-3
Columbus Blue Jackets,2014/01/10  vs. CAR,CAR,1,43,45,-2,-4,2,0,-1,32,40,-8,-4,-4,0,-2
Columbus Blue Jackets,2013/12/19  vs. PHI,PHI,1,31,63,-32,-8,-23,-1,-13,28,45,-17,-5,-11,-1,-6
Chicago Blackhawks,2013/10/17  vs. STL,STL,1,38,36,2,1,1,0,2,26,27,-1,-3,2,0,-1
San Jose Sharks,2014/04/11  vs. COL,COL,1,50,40,10,-2,12,0,-1,39,32,7,-2,9,0,0
Tampa Bay Lightning,2014/01/30  vs. OTT,OTT,1,45,44,1,3,0,-2,-9,33,31,2,3,0,-1,-6
San Jose Sharks,2013/12/19  vs. LAK,LAK,1,34,53,-19,-10,0,-9,-11,28,42,-14,-8,0,-6,-6
Carolina Hurricanes,2014/03/02  vs. ANA,ANA,1,61,48,13,-4,0,17,-5,52,34,18,-2,0,20,-1
Detroit Red Wings,2014/01/12  vs. ANA,ANA,1,41,29,12,1,0,11,2,27,21,6,2,0,4,1
Anaheim Ducks,2014/04/02  vs. EDM,EDM,1,35,35,0,-2,1,1,-2,24,33,-9,-8,1,-2,-9
Toronto Maple Leafs,2013/10/22  vs. ANA,ANA,1,34,49,-15,-6,-3,-6,-7,23,34,-11,-4,-3,-4,-7
Colorado Avalanche,2014/02/08  vs. NYI,NYI,1,32,45,-13,-11,-2,0,-16,27,36,-9,-12,3,0,-16
New Jersey Devils,2014/03/15  vs. TBL,TBL,1,35,38,-3,1,0,-4,1,28,31,-3,-1,0,-2,0
Phoenix Coyotes,2014/04/02  vs. LAK,LAK,1,36,42,-6,1,0,-7,0,26,33,-7,1,0,-8,0
Toronto Maple Leafs,2014/03/28  vs. PHI,PHI,1,40,48,-8,-1,0,-7,-1,29,32,-3,0,0,-3,2
Boston Bruins,2014/03/17  vs. MIN,MIN,1,48,43,5,2,3,0,4,32,40,-8,-7,-1,0,-7
San Jose Sharks,2013/11/14  vs. VAN,VAN,1,47,60,-13,-5,0,-8,-11,29,44,-15,-6,0,-9,-14
Washington Capitals,2013/11/30  vs. NYI,NYI,1,52,51,1,3,1,-3,7,36,38,-2,1,0,-3,3
New Jersey Devils,2013/11/21  vs. LAK,LAK,1,30,52,-22,-24,2,0,-24,22,37,-15,-17,2,0,-17
New York Islanders,2014/03/29  vs. NJD,NJD,1,38,45,-7,-2,-5,0,-7,26,31,-5,-3,-2,0,-5
Montreal Canadiens,2014/04/10  vs. NYI,NYI,1,35,63,-28,-29,0,1,-35,22,42,-20,-18,0,-2,-20
San Jose Sharks,2014/01/04  vs. COL,COL,1,48,27,21,15,0,6,12,32,22,10,10,0,0,8
Pittsburgh Penguins,2013/12/13  vs. NJD,NJD,1,40,71,-31,1,-32,0,-12,33,44,-11,1,-12,0,-2
Boston Bruins,2014/03/08  vs. TBL,TBL,1,47,29,18,11,0,7,15,34,23,11,6,0,5,9
Tampa Bay Lightning,2013/12/17  vs. NYI,NYI,1,66,44,22,5,0,17,10,42,35,7,0,0,7,2
Washington Capitals,2014/04/13  vs. TBL,TBL,1,36,58,-22,-22,0,0,-22,25,42,-17,-17,0,0,-17
Vancouver Canucks,2013/11/23  vs. CHI,CHI,1,51,41,10,-12,5,17,-7,40,33,7,-8,2,13,-5
Nashville Predators,2013/11/19  vs. DET,DET,1,27,35,-8,-1,-7,0,-1,22,25,-3,1,-4,0,1
Tampa Bay Lightning,2014/03/02  vs. COL,COL,1,51,48,3,8,3,-8,1,42,35,7,9,5,-7,4
Minnesota Wild,2014/03/17  vs. BOS,BOS,1,43,48,-5,-2,0,-3,-4,40,32,8,7,0,1,7
Montreal Canadiens,2013/10/12  vs. VAN,VAN,1,59,50,9,-3,12,0,-2,46,37,9,-2,11,0,-1
Colorado Avalanche,2014/03/14  vs. ANA,ANA,1,36,49,-13,-12,3,-4,-7,29,36,-7,-10,5,-2,-3
Winnipeg Jets,2014/01/23  vs. SJS,SJS,1,35,60,-25,-22,0,-3,-22,25,46,-21,-17,0,-4,-17
Edmonton Oilers,2014/04/04  vs. PHX,PHX,1,43,43,0,6,-5,-1,1,31,32,-1,2,-3,0,-1
New Jersey Devils,2014/04/13  vs. BOS,BOS,1,41,23,18,11,7,0,16,33,19,14,11,3,0,13
Toronto Maple Leafs,2013/12/29  vs. CAR,CAR,1,39,64,-25,-15,-10,0,-17,30,52,-22,-14,-8,0,-15
Edmonton Oilers,2013/12/13  vs. VAN,VAN,1,33,66,-33,-26,0,-7,-22,28,48,-20,-16,0,-4,-12
Chicago Blackhawks,2013/12/28  vs. STL,STL,1,41,54,-13,4,-17,0,-1,32,38,-6,2,-8,0,-2
Columbus Blue Jackets,2014/04/03  vs. PHI,PHI,1,44,49,-5,-10,5,0,-11,33,32,1,-6,7,0,-6
Calgary Flames,2013/11/01  vs. DET,DET,1,37,34,3,-1,0,4,5,27,24,3,-1,0,4,4
Toronto Maple Leafs,2014/04/03  vs. BOS,BOS,1,30,71,-41,-18,-23,0,-16,25,51,-26,-14,-12,0,-12
Dallas Stars,2013/12/17  vs. COL,COL,1,45,27,18,11,2,5,16,33,19,14,9,3,2,11
Boston Bruins,2013/11/25  vs. PIT,PIT,1,44,46,-2,7,-9,0,1,34,36,-2,8,-10,0,0
Buffalo Sabres,2013/10/12  vs. CHI,CHI,1,38,41,-3,-2,0,-1,-15,29,33,-4,-2,0,-2,-10
Chicago Blackhawks,2014/01/14  vs. COL,COL,1,56,29,27,10,0,17,17,42,22,20,9,0,11,14
Carolina Hurricanes,2013/11/15  vs. ANA,ANA,1,41,39,2,3,-4,3,6,28,36,-8,-7,-3,2,-5
Phoenix Coyotes,2013/11/16  vs. TBL,TBL,1,36,44,-8,-2,-6,0,-1,27,36,-9,-2,-7,0,-1
Columbus Blue Jackets,2014/04/12  vs. FLA,FLA,1,38,31,7,-6,11,2,1,30,27,3,-7,8,2,0
Winnipeg Jets,2013/10/06  vs. ANA,ANA,1,34,48,-14,-12,-2,0,-14,22,38,-16,-10,-6,0,-16
Phoenix Coyotes,2013/10/29  vs. LAK,LAK,1,39,65,-26,-12,-14,0,-11,30,49,-19,-14,-5,0,-13
Winnipeg Jets,2014/02/27  vs. PHX,PHX,1,37,33,4,5,-2,1,1,28,25,3,5,-2,0,1
Chicago Blackhawks,2013/11/17  vs. SJS,SJS,1,47,40,7,3,4,0,8,34,30,4,-1,5,0,1
Washington Capitals,2014/03/01  vs. BOS,BOS,1,24,48,-24,-3,-21,0,-3,19,37,-18,0,-18,0,-1
Minnesota Wild,2014/04/10  vs. STL,STL,1,15,47,-32,-2,-30,0,-15,14,41,-27,-2,-25,0,-12
St. Louis Blues,2013/12/29  vs. DAL,DAL,1,37,54,-17,-3,-14,0,-19,27,33,-6,-1,-5,0,-8
Colorado Avalanche,2014/03/18  vs. MTL,MTL,1,45,50,-5,-8,1,2,-7,33,38,-5,-6,0,1,-6
Philadelphia Flyers,2014/01/28  vs. DET,DET,1,38,51,-13,-7,-6,0,-7,30,38,-8,-4,-4,0,-3
Washington Capitals,2014/04/10  vs. CAR,CAR,1,37,67,-30,-3,-27,0,-7,28,47,-19,-2,-17,0,-1
Phoenix Coyotes,2013/11/06  vs. ANA,ANA,1,41,38,3,-10,1,12,-9,32,29,3,-6,1,8,-5
Washington Capitals,2013/12/07  vs. NSH,NSH,1,55,61,-6,3,-9,0,4,42,41,1,5,-4,0,7
Boston Bruins,2013/10/05  vs. DET,DET,1,45,42,3,-1,4,0,4,38,31,7,2,5,0,6
Detroit Red Wings,2013/12/15  vs. TBL,TBL,1,43,43,0,-3,0,3,-3,30,33,-3,-3,0,0,-3
Buffalo Sabres,2014/03/11  vs. NSH,NSH,1,35,44,-9,-2,-10,3,-16,26,30,-4,0,-5,1,-8
Tampa Bay Lightning,2013/10/29  vs. NJD,NJD,1,23,28,-5,-8,0,3,-8,18,23,-5,-8,0,3,-7
Winnipeg Jets,2013/10/20  vs. NSH,NSH,1,55,30,25,3,0,22,9,41,26,15,-1,0,16,4
Detroit Red Wings,2013/12/01  vs. OTT,OTT,1,33,51,-18,-5,-13,0,-12,23,38,-15,-5,-10,0,-8
St. Louis Blues,2013/11/02  vs. TBL,TBL,1,38,41,-3,4,-1,-6,0,28,28,0,4,1,-5,3
Calgary Flames,2013/12/23  vs. STL,STL,1,32,44,-12,-3,0,-9,-9,21,36,-15,-3,0,-12,-8
Columbus Blue Jackets,2013/10/19  vs. WSH,WSH,1,56,55,1,-6,0,7,4,46,43,3,-4,0,7,7
Tampa Bay Lightning,2014/01/18  vs. SJS,SJS,1,50,50,0,6,0,-6,1,39,39,0,4,2,-6,-2
Washington Capitals,2014/04/11  vs. CHI,CHI,1,45,59,-14,0,-14,0,-4,38,44,-6,0,-6,0,-3
Dallas Stars,2013/10/26  vs. WPG,WPG,1,56,53,3,6,0,-3,2,44,41,3,3,0,0,1
Dallas Stars,2014/03/01  vs. TBL,TBL,1,66,36,30,-1,0,31,4,45,28,17,-1,0,18,0
Edmonton Oilers,2013/10/19  vs. OTT,OTT,1,17,47,-30,-6,-24,0,-11,17,35,-18,-5,-13,0,-9
Los Angeles Kings,2014/01/18  vs. DET,DET,1,39,51,-12,-9,-3,0,-11,30,38,-8,-6,-2,0,-8
Edmonton Oilers,2013/11/29  vs. CBJ,CBJ,1,27,29,-2,-3,0,1,-9,22,16,6,0,0,6,0
Colorado Avalanche,2013/12/17  vs. DAL,DAL,1,27,45,-18,-11,-5,-2,-16,19,33,-14,-9,-2,-3,-11
Phoenix Coyotes,2014/02/28  vs. COL,COL,1,47,46,1,1,2,-2,3,35,35,0,-1,2,-1,1
Buffalo Sabres,2014/03/20  vs. EDM,EDM,1,39,36,3,1,5,-3,-2,28,27,1,-3,5,-1,-4
Buffalo Sabres,2014/01/15  vs. TOR,TOR,1,47,49,-2,-5,0,3,-2,36,38,-2,-7,0,5,-2
Montreal Canadiens,2014/02/01  vs. TBL,TBL,1,36,48,-12,-7,0,-5,-10,26,35,-9,-5,0,-4,-6
Edmonton Oilers,2013/11/25  vs. CHI,CHI,1,37,35,2,2,0,0,1,27,29,-2,2,0,-4,1
Toronto Maple Leafs,2014/03/19  vs. TBL,TBL,1,45,51,-6,-9,0,3,-16,35,39,-4,-7,1,2,-11
San Jose Sharks,2013/10/15  vs. STL,STL,1,42,44,-2,6,-8,0,6,38,30,8,6,2,0,6
Buffalo Sabres,2014/03/23  vs. VAN,VAN,1,35,73,-38,-6,-16,-16,-34,22,54,-32,-6,-12,-14,-28
Toronto Maple Leafs,2013/12/05  vs. DAL,DAL,1,33,62,-29,-15,-14,0,-23,25,48,-23,-14,-9,0,-20
Philadelphia Flyers,2014/04/06  vs. BUF,BUF,1,56,28,28,1,27,0,22,40,19,21,2,19,0,14
Florida Panthers,2014/01/04  vs. NSH,NSH,1,44,41,3,7,-1,-3,4,38,36,2,5,-1,-2,3
Tampa Bay Lightning,2014/03/08  vs. BOS,BOS,1,29,47,-18,-11,-7,0,-15,23,34,-11,-6,-5,0,-9
New York Rangers,2014/01/21  vs. NYI,NYI,1,43,48,-5,4,-11,2,-6,37,40,-3,5,-8,0,-2
Colorado Avalanche,2013/11/08  vs. CGY,CGY,1,39,60,-21,7,-28,0,-13,26,45,-19,3,-22,0,-13
New Jersey Devils,2014/01/11  vs. FLA,FLA,1,47,35,12,1,11,0,12,38,30,8,-2,10,0,8
Minnesota Wild,2014/01/02  vs. BUF,BUF,1,37,26,11,7,4,0,5,32,20,12,7,5,0,6
Buffalo Sabres,2013/10/28  vs. DAL,DAL,1,34,35,-1,-2,0,1,3,23,26,-3,-3,0,0,1
New Jersey Devils,2013/11/10  vs. NSH,NSH,1,28,14,14,5,9,0,10,19,12,7,3,4,0,5
San Jose Sharks,2013/10/17  vs. DAL,DAL,1,56,47,9,8,1,0,9,38,33,5,3,2,0,5
Toronto Maple Leafs,2013/11/09  vs. BOS,BOS,1,41,51,-10,-5,0,-5,1,30,38,-8,-5,0,-3,1
Tampa Bay Lightning,2013/12/07  vs. WPG,WPG,1,50,35,15,15,0,0,15,40,29,11,13,0,-2,11
St. Louis Blues,2014/01/10  vs. VAN,VAN,1,49,41,8,4,0,4,6,37,26,11,9,0,2,10
Colorado Avalanche,2013/11/12  vs. CAR,CAR,1,57,58,-1,-11,0,10,0,42,46,-4,-8,0,4,-3
Carolina Hurricanes,2013/12/09  vs. VAN,VAN,1,48,40,8,3,0,5,2,37,29,8,3,0,5,3
Tampa Bay Lightning,2014/01/13  vs. CBJ,CBJ,1,36,44,-8,-2,-3,-3,-2,27,34,-7,-1,-2,-4,-2
Los Angeles Kings,2014/03/25  vs. WSH,WSH,1,51,24,27,5,2,20,13,39,19,20,5,3,12,9
New York Islanders,2013/12/29  vs. MIN,MIN,1,41,47,-6,-11,-3,8,-11,32,39,-7,-11,-2,6,-9
Los Angeles Kings,2013/11/15  vs. NJD,NJD,1,34,38,-4,-6,2,0,-6,23,31,-8,-10,2,0,-10
Minnesota Wild,2013/12/31  vs. STL,STL,1,52,46,6,1,0,5,1,29,33,-4,-4,0,0,-3
Montreal Canadiens,2013/12/14  vs. NYI,NYI,1,49,36,13,13,0,0,13,35,19,16,16,0,0,16
Vancouver Canucks,2013/12/22  vs. WPG,WPG,1,44,46,-2,-10,8,0,-6,27,24,3,-7,10,0,-2
Calgary Flames,2014/03/18  vs. BUF,BUF,1,49,33,16,-6,8,14,8,37,22,15,-4,6,13,9
Calgary Flames,2014/04/11  vs. WPG,WPG,1,57,50,7,-7,0,14,1,39,34,5,-1,0,6,3
Minnesota Wild,2013/12/23  vs. PHI,PHI,1,43,44,-1,2,0,-3,2,35,27,8,2,0,6,5
Toronto Maple Leafs,2013/10/26  vs. PIT,PIT,1,41,49,-8,-17,4,5,-12,27,39,-12,-16,2,2,-14
Nashville Predators,2013/11/30  vs. PHI,PHI,1,47,26,21,22,-1,0,22,38,20,18,17,1,0,17
Chicago Blackhawks,2014/03/01  vs. PIT,PIT,1,40,35,5,6,-1,0,9,35,24,11,6,5,0,10
Chicago Blackhawks,2013/12/17  vs. NSH,NSH,1,27,31,-4,-10,6,0,-12,22,17,5,-6,11,0,-4
Vancouver Canucks,2014/03/17  vs. TBL,TBL,1,36,46,-10,-1,0,-9,-6,25,34,-9,0,0,-9,-7
Vancouver Canucks,2014/03/27  vs. COL,COL,1,46,43,3,5,-2,0,3,29,32,-3,1,0,-4,-3
Columbus Blue Jackets,2014/03/13  vs. SJS,SJS,1,55,37,18,-6,16,8,11,40,27,13,-5,13,5,9
New Jersey Devils,2013/11/03  vs. MIN,MIN,1,42,26,16,5,0,11,1,25,19,6,4,0,2,1
Carolina Hurricanes,2013/12/03  vs. WSH,WSH,1,37,43,-6,1,-7,0,-7,27,33,-6,2,-8,0,-6
San Jose Sharks,2014/01/29  vs. EDM,EDM,1,83,26,57,15,0,42,41,66,21,45,12,0,33,36
Columbus Blue Jackets,2013/10/20  vs. VAN,VAN,1,28,47,-19,-6,-13,0,-16,25,35,-10,-1,-9,0,-7
San Jose Sharks,2014/04/03  vs. LAK,LAK,1,42,59,-17,1,-3,-15,-12,27,38,-11,0,-2,-9,-9
Montreal Canadiens,2013/11/12  vs. TBL,TBL,1,44,62,-18,-14,0,-4,-15,34,43,-9,-8,0,-1,-10
Columbus Blue Jackets,2013/11/12  vs. WSH,WSH,1,44,45,-1,-1,-1,1,0,29,30,-1,1,-2,0,2
Anaheim Ducks,2014/04/12  vs. LAK,LAK,1,27,47,-20,-7,-11,-2,-19,18,30,-12,-2,-9,-1,-13
New Jersey Devils,2014/04/07  vs. CGY,CGY,1,44,26,18,13,0,5,13,33,23,10,8,0,2,8
Chicago Blackhawks,2013/10/15  vs. CAR,CAR,1,55,53,2,10,-8,0,11,44,35,9,10,-1,0,11
Carolina Hurricanes,2013/10/25  vs. COL,COL,1,49,50,-1,-3,0,2,-10,34,38,-4,-4,0,0,-10
New York Islanders,2014/03/15  vs. BUF,BUF,1,54,42,12,0,12,0,3,40,29,11,0,11,0,4
Florida Panthers,2013/11/02  vs. WSH,WSH,1,45,34,11,11,0,0,10,27,27,0,4,0,-4,-2
St. Louis Blues,2014/03/11  vs. DAL,DAL,1,44,41,3,6,-2,-1,4,30,35,-5,-2,-1,-2,-3
Washington Capitals,2014/04/01  vs. DAL,DAL,1,51,45,6,2,0,4,-4,34,38,-4,-1,0,-3,-7
New York Islanders,2014/01/25  vs. STL,STL,1,36,43,-7,4,-11,0,-3,28,36,-8,4,-12,0,-4
Vancouver Canucks,2014/03/12  vs. WPG,WPG,1,42,43,-1,1,0,-2,2,31,32,-1,-2,0,1,1
Minnesota Wild,2014/01/25  vs. SJS,SJS,1,38,61,-23,-34,11,0,-27,28,40,-12,-23,11,0,-16
Detroit Red Wings,2013/10/19  vs. PHX,PHX,1,43,47,-4,-6,3,-1,-5,37,32,5,-5,9,1,-3
Washington Capitals,2013/11/22  vs. MTL,MTL,1,53,42,11,4,0,7,0,39,28,11,3,0,8,-1
Vancouver Canucks,2013/10/17  vs. BUF,BUF,1,42,34,8,6,2,0,8,34,19,15,7,8,0,12
San Jose Sharks,2014/03/02  vs. NJD,NJD,1,27,27,0,2,0,-2,1,22,26,-4,-2,0,-2,-3
Colorado Avalanche,2013/11/10  vs. WSH,WSH,1,51,43,8,-1,9,0,10,35,32,3,-1,4,0,6
Florida Panthers,2014/03/07  vs. BUF,BUF,1,36,36,0,0,0,0,7,30,25,5,0,5,0,6
Nashville Predators,2014/03/18  vs. EDM,EDM,1,44,42,2,-4,0,6,1,32,31,1,-4,0,5,1
Detroit Red Wings,2014/01/28  vs. PHI,PHI,1,51,38,13,7,0,6,7,38,30,8,4,0,4,3
Columbus Blue Jackets,2013/11/25  vs. TOR,TOR,1,40,51,-11,-1,-10,0,0,27,33,-6,-1,-5,0,0
Nashville Predators,2014/03/21  vs. CGY,CGY,1,34,49,-15,-11,-4,0,-14,24,41,-17,-13,-4,0,-14
Florida Panthers,2014/03/20  vs. PHX,PHX,1,37,38,-1,-2,0,1,-2,28,26,2,-1,0,3,1
Minnesota Wild,2014/03/18  vs. NYI,NYI,1,42,49,-7,-9,2,0,-11,26,30,-4,-7,3,0,-8
Tampa Bay Lightning,2014/02/06  vs. TOR,TOR,1,70,50,20,18,0,2,22,52,42,10,11,0,-1,12
Florida Panthers,2013/11/10  vs. NYR,NYR,1,45,47,-2,3,-3,-2,-6,35,35,0,2,-2,0,-3
New York Rangers,2013/12/22  vs. MIN,MIN,1,42,38,4,-1,11,-6,2,41,26,15,3,15,-3,9
Detroit Red Wings,2014/03/22  vs. MIN,MIN,1,39,39,0,-6,2,4,-4,33,31,2,-6,4,4,-3
Vancouver Canucks,2013/11/07  vs. SJS,SJS,1,38,37,1,1,2,-2,4,32,25,7,1,7,-1,6
Winnipeg Jets,2013/12/16  vs. CBJ,CBJ,1,35,39,-4,1,-5,0,4,28,24,4,6,-2,0,8
Columbus Blue Jackets,2013/12/16  vs. WPG,WPG,1,39,35,4,-1,0,5,-4,24,28,-4,-6,0,2,-8
San Jose Sharks,2013/11/27  vs. LAK,LAK,1,60,44,16,-9,5,20,8,46,33,13,-5,2,16,8
Toronto Maple Leafs,2013/12/14  vs. CHI,CHI,1,46,58,-12,0,-12,0,-7,38,35,3,0,3,0,-4
Boston Bruins,2014/03/30  vs. PHI,PHI,1,41,53,-12,2,-13,-1,-2,29,45,-16,1,-15,-2,-6
Anaheim Ducks,2013/12/23  vs. WSH,WSH,1,36,40,-4,-2,-2,0,1,28,27,1,0,0,1,2
Los Angeles Kings,2013/10/09  vs. OTT,OTT,1,49,37,12,1,11,0,3,37,27,10,2,8,0,3
Montreal Canadiens,2014/04/04  vs. OTT,OTT,1,27,58,-31,-6,-26,1,-15,24,48,-24,-5,-21,2,-12
San Jose Sharks,2013/11/12  vs. CGY,CGY,1,68,27,41,6,35,0,27,46,15,31,3,28,0,18
Ottawa Senators,2013/12/28  vs. BOS,BOS,1,51,41,10,-3,13,0,5,35,36,-1,-7,6,0,-2
Boston Bruins,2014/03/27  vs. CHI,CHI,1,38,41,-3,3,-6,0,4,29,33,-4,2,-6,0,2
Winnipeg Jets,2013/12/20  vs. FLA,FLA,1,43,39,4,6,-2,0,6,38,26,12,5,7,0,5
Detroit Red Wings,2013/12/12  vs. TBL,TBL,1,35,40,-5,-9,4,0,-5,25,34,-9,-9,0,0,-9
Calgary Flames,2014/01/18  vs. VAN,VAN,1,45,45,0,-1,1,0,-1,34,30,4,3,1,0,3
Minnesota Wild,2013/12/14  vs. COL,COL,1,49,40,9,-7,0,16,5,35,27,8,0,0,8,5
New York Islanders,2013/10/11  vs. CHI,CHI,1,30,54,-24,-7,0,-17,-16,19,35,-16,-7,0,-9,-12
Pittsburgh Penguins,2014/03/10  vs. WSH,WSH,1,36,53,-17,-6,-11,0,-10,25,37,-12,-5,-7,0,-12
Nashville Predators,2014/03/10  vs. OTT,OTT,1,57,58,-1,7,-8,0,10,47,44,3,7,-4,0,9
Tampa Bay Lightning,2013/11/22  vs. ANA,ANA,1,38,45,-7,-7,0,0,-7,31,35,-4,-4,0,0,-4
Columbus Blue Jackets,2013/11/07  vs. NYR,NYR,1,49,40,9,-2,0,11,-3,34,29,5,-1,0,6,-4
San Jose Sharks,2013/12/03  vs. TOR,TOR,1,71,35,36,17,19,0,27,54,27,27,15,12,0,19
Los Angeles Kings,2014/01/13  vs. VAN,VAN,1,29,22,7,4,3,0,4,18,18,0,-1,1,0,-1
Dallas Stars,2013/11/29  vs. CHI,CHI,1,44,51,-7,0,-7,0,-4,34,30,4,6,-2,0,6
Washington Capitals,2014/03/06  vs. BOS,BOS,1,32,65,-33,-13,0,-20,-21,25,53,-28,-10,0,-18,-18
Vancouver Canucks,2014/01/01  vs. TBL,TBL,1,49,52,-3,-10,3,4,-8,40,37,3,-1,3,1,1
Nashville Predators,2013/12/07  vs. WSH,WSH,1,61,55,6,-3,0,9,-4,41,42,-1,-5,0,4,-7
New Jersey Devils,2014/01/07  vs. PHI,PHI,1,38,33,5,4,1,0,8,36,29,7,3,4,0,10
Dallas Stars,2013/10/28  vs. BUF,BUF,1,35,34,1,2,-1,0,-3,26,23,3,3,0,0,-1
Dallas Stars,2014/04/11  vs. STL,STL,1,56,33,23,1,22,0,4,44,26,18,0,18,0,5
Toronto Maple Leafs,2013/11/25  vs. CBJ,CBJ,1,51,40,11,1,0,10,0,33,27,6,1,0,5,0
New York Islanders,2014/03/07  vs. CGY,CGY,1,39,43,-4,-10,-3,9,-4,30,32,-2,-3,-5,6,0
Boston Bruins,2014/02/08  vs. OTT,OTT,1,60,30,30,2,28,0,4,52,25,27,2,25,0,3
Ottawa Senators,2013/12/14  vs. LAK,LAK,1,56,41,15,0,0,15,2,43,29,14,0,0,14,0
Buffalo Sabres,2014/04/12  vs. BOS,BOS,1,27,45,-18,-7,0,-11,-8,22,32,-10,-2,0,-8,-4
Ottawa Senators,2013/12/27  vs. BOS,BOS,1,52,58,-6,3,0,-9,-2,41,44,-3,4,0,-7,0
Nashville Predators,2014/03/15  vs. STL,STL,1,49,40,9,2,0,7,0,36,30,6,2,0,4,2
Winnipeg Jets,2013/11/08  vs. NSH,NSH,1,53,53,0,2,-2,0,4,40,39,1,1,0,0,4
Minnesota Wild,2013/12/02  vs. PHI,PHI,1,34,45,-11,-7,-4,0,-7,28,31,-3,-1,-2,0,-1
Phoenix Coyotes,2014/02/08  vs. DAL,DAL,1,31,54,-23,-1,0,-22,-18,24,40,-16,0,0,-16,-12
Calgary Flames,2013/12/29  vs. VAN,VAN,1,36,42,-6,-7,0,1,-15,25,35,-10,-6,0,-4,-17
Minnesota Wild,2014/02/01  vs. CGY,CGY,1,34,34,0,-1,0,1,-9,26,29,-3,0,0,-3,-9
New York Islanders,2013/11/30  vs. WSH,WSH,1,51,52,-1,-3,3,-1,-7,38,36,2,-1,3,0,-3
Dallas Stars,2013/12/07  vs. PHI,PHI,1,36,45,-9,-6,0,-3,-7,30,26,4,0,5,-1,1
Colorado Avalanche,2013/12/14  vs. MIN,MIN,1,40,49,-9,7,-16,0,-5,27,35,-8,0,-8,0,-5
New York Islanders,2014/01/16  vs. TBL,TBL,1,38,45,-7,-16,0,9,-7,27,37,-10,-15,0,5,-10
St. Louis Blues,2014/04/13  vs. DET,DET,1,37,36,1,1,0,0,-3,26,29,-3,0,0,-3,-5
Boston Bruins,2013/12/05  vs. MTL,MTL,1,58,38,20,2,-5,23,-8,38,28,10,3,-2,9,-2
New York Islanders,2014/01/07  vs. TOR,TOR,1,41,37,4,5,-1,0,7,32,31,1,3,0,-2,4
St. Louis Blues,2013/10/12  vs. NYR,NYR,1,49,29,20,9,11,0,8,37,23,14,8,6,0,4
Chicago Blackhawks,2013/11/29  vs. DAL,DAL,1,51,44,7,0,0,7,4,30,34,-4,-6,0,2,-6
Florida Panthers,2013/10/05  vs. STL,STL,1,32,37,-5,-1,0,-4,4,24,33,-9,-1,0,-8,-1
Phoenix Coyotes,2013/12/04  vs. CGY,CGY,1,52,31,21,2,3,16,0,34,19,15,0,4,11,1
Philadelphia Flyers,2013/10/24  vs. NYR,NYR,1,33,55,-22,-2,-20,0,-7,27,40,-13,-4,-9,0,-6
Philadelphia Flyers,2013/11/19  vs. OTT,OTT,1,54,30,24,10,14,0,15,39,21,18,8,10,0,8
New York Islanders,2013/12/14  vs. MTL,MTL,1,36,49,-13,-13,0,0,-13,19,35,-16,-16,0,0,-16
Florida Panthers,2013/10/13  vs. LAK,LAK,1,28,51,-23,-7,0,-16,-12,24,36,-12,-3,0,-9,-8
Toronto Maple Leafs,2014/01/01  vs. DET,DET,1,30,43,-13,-5,-6,-2,-7,25,36,-11,-4,-4,-3,-7
Colorado Avalanche,2013/11/30  vs. MIN,MIN,1,45,50,-5,4,-9,0,-2,29,35,-6,2,-8,0,-4
Winnipeg Jets,2013/12/12  vs. COL,COL,1,45,48,-3,-6,-4,7,-12,32,26,6,0,-1,7,-3
Carolina Hurricanes,2013/11/05  vs. PHI,PHI,1,55,52,3,1,0,2,1,42,33,9,7,0,2,7
Tampa Bay Lightning,2013/11/01  vs. CAR,CAR,1,49,48,1,-2,3,0,2,37,32,5,0,5,0,5
Montreal Canadiens,2014/01/18  vs. TOR,TOR,1,50,45,5,-9,0,14,-6,38,33,5,-5,0,10,-3
Colorado Avalanche,2014/03/21  vs. BOS,BOS,1,36,44,-8,2,0,-10,9,27,33,-6,0,0,-6,9
Dallas Stars,2014/03/24  vs. WPG,WPG,1,36,51,-15,-5,-10,0,-6,26,35,-9,-4,-5,0,-4
Ottawa Senators,2014/01/28  vs. CBJ,CBJ,1,43,41,2,11,-9,0,5,25,30,-5,5,-10,0,-3
Ottawa Senators,2014/04/04  vs. MTL,MTL,1,58,27,31,6,-1,26,15,48,24,24,5,-2,21,12
Winnipeg Jets,2013/10/18  vs. STL,STL,1,55,51,4,10,0,-6,-1,40,36,4,7,0,-3,0
Anaheim Ducks,2013/10/10  vs. NYR,NYR,1,37,45,-8,2,-10,0,5,31,33,-2,2,-4,0,6
Colorado Avalanche,2014/01/06  vs. CGY,CGY,1,32,40,-8,-10,1,1,-9,21,30,-9,-8,1,-2,-8
Boston Bruins,2013/10/12  vs. CBJ,CBJ,1,44,39,5,11,-6,0,11,36,25,11,11,0,0,11
Winnipeg Jets,2014/01/02  vs. OTT,OTT,1,55,51,4,4,0,0,9,43,36,7,5,0,2,11
Boston Bruins,2013/10/14  vs. DET,DET,1,47,39,8,6,0,2,5,32,35,-3,-1,0,-2,-2
New Jersey Devils,2013/11/16  vs. PIT,PIT,1,30,31,-1,4,-5,0,3,25,24,1,3,-2,0,3
Phoenix Coyotes,2014/01/14  vs. STL,STL,1,40,28,12,3,0,9,3,25,20,5,-1,0,6,0
Buffalo Sabres,2013/11/16  vs. TOR,TOR,1,48,38,10,-5,0,15,-13,34,29,5,-4,0,9,-8
Vancouver Canucks,2014/03/26  vs. MIN,MIN,1,35,51,-16,-3,-13,0,-2,25,34,-9,-3,-6,0,-2
New York Rangers,2013/10/07  vs. LAK,LAK,1,45,44,1,-6,7,0,-6,35,33,2,-3,5,0,-1
San Jose Sharks,2013/12/27  vs. PHX,PHX,1,50,51,-1,-9,-2,10,1,33,38,-5,-8,-1,4,-4
New York Rangers,2014/02/06  vs. EDM,EDM,1,60,46,14,13,0,1,15,48,39,9,7,0,2,10
New York Rangers,2013/12/31  vs. FLA,FLA,1,32,31,1,3,0,-2,-3,22,25,-3,1,0,-4,-6
Chicago Blackhawks,2014/02/01  vs. SJS,SJS,1,50,34,16,16,0,0,16,36,26,10,10,0,0,10
Toronto Maple Leafs,2013/10/19  vs. CHI,CHI,1,28,50,-22,-16,0,-6,-19,19,37,-18,-10,0,-8,-15
New York Islanders,2014/03/06  vs. EDM,EDM,1,51,39,12,2,10,0,6,41,32,9,4,5,0,9
Los Angeles Kings,2014/02/03  vs. CHI,CHI,1,44,38,6,6,0,0,-1,38,30,8,7,0,1,1
Colorado Avalanche,2013/10/25  vs. CAR,CAR,1,50,49,1,3,-2,0,10,38,34,4,4,0,0,10
Vancouver Canucks,2013/12/20  vs. CHI,CHI,1,37,40,-3,-8,0,5,-3,25,32,-7,-7,0,0,-3
Washington Capitals,2014/03/14  vs. VAN,VAN,1,40,50,-10,3,-13,0,3,30,37,-7,2,-9,0,4
Winnipeg Jets,2014/02/02  vs. MTL,MTL,1,55,42,13,21,-8,0,13,35,27,8,10,-2,0,5
Dallas Stars,2014/01/14  vs. EDM,EDM,1,53,54,-1,1,-2,0,2,40,40,0,3,-3,0,4
Minnesota Wild,2014/02/04  vs. TBL,TBL,1,33,48,-15,0,-15,0,0,24,39,-15,-1,-14,0,-2
Phoenix Coyotes,2014/03/22  vs. BOS,BOS,1,39,49,-10,-5,-10,5,-7,33,35,-2,0,-6,4,-1
Chicago Blackhawks,2013/12/11  vs. PHI,PHI,1,31,35,-4,-3,2,-3,-4,19,25,-6,-3,-1,-2,-6
Washington Capitals,2014/03/08  vs. PHX,PHX,1,42,43,-1,-5,0,4,-6,33,36,-3,-3,1,-1,-4
Carolina Hurricanes,2014/03/04  vs. SJS,SJS,1,54,68,-14,-16,1,1,-14,40,52,-12,-12,1,-1,-12
Edmonton Oilers,2013/12/27  vs. CGY,CGY,1,34,44,-10,-2,-8,0,-10,28,32,-4,-2,-2,0,-4
San Jose Sharks,2014/01/20  vs. CGY,CGY,1,57,54,3,20,-13,-4,15,36,31,5,11,-4,-2,12
Tampa Bay Lightning,2014/04/03  vs. CGY,CGY,1,57,35,22,4,0,18,5,37,27,10,2,0,8,2
Dallas Stars,2013/11/17  vs. VAN,VAN,1,38,58,-20,-1,-19,0,-19,30,40,-10,1,-11,0,-11
Dallas Stars,2013/12/23  vs. LAK,LAK,1,34,55,-21,-6,-18,3,-10,25,43,-18,-5,-15,2,-10
New York Islanders,2013/12/09  vs. ANA,ANA,1,55,49,6,11,-1,-4,10,39,33,6,10,-5,1,5
Buffalo Sabres,2014/01/12  vs. WSH,WSH,1,39,49,-10,-10,0,0,-10,26,34,-8,-9,0,1,-8
Ottawa Senators,2013/10/23  vs. DET,DET,1,45,45,0,-3,3,0,-1,37,34,3,-3,6,0,-1
Winnipeg Jets,2013/10/26  vs. DAL,DAL,1,53,56,-3,-6,3,0,-2,41,44,-3,-3,0,0,-1
Columbus Blue Jackets,2013/12/06  vs. MIN,MIN,1,45,26,19,0,19,0,7,38,16,22,1,21,0,8
Pittsburgh Penguins,2014/04/09  vs. DET,DET,1,37,53,-16,1,-6,-11,-10,26,38,-12,0,-6,-6,-6
Dallas Stars,2014/01/04  vs. DET,DET,1,63,39,24,3,0,21,3,47,29,18,4,0,14,3
San Jose Sharks,2014/02/03  vs. PHI,PHI,1,33,55,-22,-5,-21,4,-25,19,38,-19,-7,-15,3,-20
Winnipeg Jets,2013/12/17  vs. BUF,BUF,1,52,46,6,-17,15,8,-9,41,36,5,-14,11,8,-9
Montreal Canadiens,2014/01/14  vs. NJD,NJD,1,37,42,-5,-2,-1,-2,-3,29,32,-3,-1,-3,1,-4
Florida Panthers,2013/12/31  vs. NYR,NYR,1,31,32,-1,-3,2,0,3,25,22,3,-1,4,0,6
Ottawa Senators,2013/11/12  vs. PHI,PHI,1,45,47,-2,-5,0,3,-7,33,35,-2,-2,0,0,-5
Philadelphia Flyers,2013/10/11  vs. PHX,PHX,1,49,47,2,-2,0,4,-4,40,35,5,0,0,5,-1
Minnesota Wild,2014/03/15  vs. CBJ,CBJ,1,49,47,2,1,0,1,1,40,39,1,0,0,1,0
Vancouver Canucks,2013/11/17  vs. DAL,DAL,1,58,38,20,1,0,19,19,40,30,10,-1,0,11,11
Vancouver Canucks,2013/10/12  vs. MTL,MTL,1,50,59,-9,3,0,-12,2,37,46,-9,2,0,-11,1
Florida Panthers,2014/04/08  vs. PHI,PHI,1,55,36,19,6,0,13,13,44,31,13,2,0,11,9
Winnipeg Jets,2013/11/12  vs. DET,DET,1,31,48,-17,-18,1,0,-17,24,43,-19,-22,3,0,-19
Chicago Blackhawks,2013/10/09  vs. STL,STL,1,47,45,2,5,0,-3,3,34,37,-3,0,0,-3,-2
Toronto Maple Leafs,2013/11/02  vs. VAN,VAN,1,27,54,-27,-10,0,-17,-9,19,44,-25,-10,0,-15,-7
New Jersey Devils,2014/03/07  vs. DET,DET,1,37,37,0,2,-2,0,1,24,34,-10,0,-2,-8,-2
Toronto Maple Leafs,2013/11/13  vs. MIN,MIN,1,24,54,-30,-20,-10,0,-33,17,41,-24,-16,-8,0,-26
Tampa Bay Lightning,2013/12/14  vs. NJD,NJD,1,42,34,8,5,0,3,8,38,25,13,9,0,4,12
Colorado Avalanche,2014/02/28  vs. PHX,PHX,1,46,47,-1,-1,2,-2,-3,35,35,0,1,1,-2,-1
Buffalo Sabres,2013/12/21  vs. BOS,BOS,1,49,52,-3,1,0,-4,-7,40,41,-1,1,0,-2,-7
Carolina Hurricanes,2013/12/14  vs. PHX,PHX,1,52,52,0,-4,5,-1,-5,35,39,-4,-5,3,-2,-7
Montreal Canadiens,2013/10/01  vs. TOR,TOR,1,56,39,17,-3,11,9,9,44,26,18,0,10,8,11
Winnipeg Jets,2014/04/05  vs. TOR,TOR,1,64,28,36,21,12,3,28,53,23,30,19,10,1,22
Detroit Red Wings,2014/04/08  vs. BUF,BUF,1,45,31,14,10,4,0,10,32,23,9,6,3,0,6
Calgary Flames,2014/03/07  vs. NYI,NYI,1,43,39,4,10,-9,3,4,32,30,2,3,-6,5,0
Los Angeles Kings,2013/12/21  vs. COL,COL,1,57,46,11,11,0,0,13,46,35,11,8,3,0,9
Buffalo Sabres,2013/10/05  vs. PIT,PIT,1,32,55,-23,-5,0,-18,-8,18,41,-23,-3,0,-20,-6
Nashville Predators,2014/01/31  vs. NJD,NJD,1,34,37,-3,6,-2,-7,4,31,26,5,7,1,-3,8
Winnipeg Jets,2014/01/04  vs. BOS,BOS,1,56,51,5,-5,-2,12,-6,44,40,4,-6,-1,11,-6
Dallas Stars,2014/03/14  vs. CGY,CGY,1,46,65,-19,-24,5,0,-23,37,46,-9,-20,11,0,-17
Pittsburgh Penguins,2014/03/22  vs. TBL,TBL,1,30,30,0,-1,2,-1,1,22,24,-2,0,-1,-1,-1
Anaheim Ducks,2014/02/08  vs. NSH,NSH,1,41,47,-6,-7,2,-1,-10,28,36,-8,-3,-4,-1,-7
Dallas Stars,2013/11/26  vs. ANA,ANA,1,47,52,-5,0,-7,2,-2,39,40,-1,0,1,-2,-4
San Jose Sharks,2013/10/05  vs. PHX,PHX,1,57,36,21,0,21,0,-2,46,24,22,0,22,0,-3
Edmonton Oilers,2014/01/26  vs. NSH,NSH,1,45,55,-10,3,-13,0,9,34,39,-5,4,-9,0,4
New York Islanders,2014/03/25  vs. CAR,CAR,1,42,48,-6,6,-12,0,2,35,35,0,5,-5,0,5
St. Louis Blues,2014/03/17  vs. WPG,WPG,1,52,28,24,20,4,0,24,38,19,19,13,6,0,18
Toronto Maple Leafs,2013/11/27  vs. PIT,PIT,1,38,67,-29,-21,-6,-2,-28,27,47,-20,-20,0,0,-18
San Jose Sharks,2014/02/01  vs. CHI,CHI,1,34,50,-16,-16,0,0,-16,26,36,-10,-10,0,0,-10
Carolina Hurricanes,2013/11/07  vs. NYI,NYI,1,45,48,-3,-8,5,0,-4,34,37,-3,-6,3,0,-4
San Jose Sharks,2014/02/27  vs. PHI,PHI,1,43,36,7,1,13,-7,1,34,29,5,-1,10,-4,0
Dallas Stars,2014/01/02  vs. MTL,MTL,1,55,42,13,11,2,0,12,38,30,8,8,1,-1,7
Anaheim Ducks,2014/02/03  vs. CBJ,CBJ,1,60,41,19,4,0,15,11,43,30,13,6,0,7,9
Calgary Flames,2014/01/24  vs. NSH,NSH,1,42,41,1,-4,0,5,-7,33,33,0,-2,0,2,-7
New York Islanders,2013/11/23  vs. PHI,PHI,1,54,61,-7,-8,0,1,-8,37,43,-6,-6,0,0,-6
Montreal Canadiens,2013/10/10  vs. EDM,EDM,1,45,46,-1,1,-3,1,-5,27,31,-4,-1,-3,0,-4
Vancouver Canucks,2014/01/31  vs. WPG,WPG,1,51,48,3,-1,0,4,-5,35,34,1,0,0,1,-6
Toronto Maple Leafs,2014/01/04  vs. NYR,NYR,1,46,73,-27,-7,0,-20,-10,39,59,-20,-6,0,-14,-8
Philadelphia Flyers,2013/12/15  vs. WSH,WSH,1,36,33,3,2,3,-2,4,25,25,0,4,-2,-2,5
Winnipeg Jets,2013/11/18  vs. CGY,CGY,1,66,38,28,23,0,5,28,39,25,14,15,0,-1,16
Washington Capitals,2013/12/10  vs. TBL,TBL,1,23,54,-31,-9,0,-22,-18,20,38,-18,-6,0,-12,-9
Florida Panthers,2013/10/08  vs. PHI,PHI,1,49,37,12,3,0,9,3,37,27,10,4,0,6,3
New York Rangers,2014/03/26  vs. PHI,PHI,1,51,46,5,-1,6,0,-3,39,30,9,0,9,0,-2
Ottawa Senators,2013/12/30  vs. WSH,WSH,1,44,55,-11,0,-8,-3,-12,37,42,-5,0,-1,-4,-8
Boston Bruins,2014/04/02  vs. DET,DET,1,42,27,15,10,1,4,15,33,24,9,6,1,2,10
New York Islanders,2014/04/08  vs. OTT,OTT,1,43,41,2,-3,0,5,1,38,36,2,-3,0,5,1
Phoenix Coyotes,2014/01/13  vs. WPG,WPG,1,33,41,-8,3,-2,-9,-9,20,35,-15,-2,-2,-11,-13
Calgary Flames,2014/04/13  vs. VAN,VAN,1,38,48,-10,3,0,-13,3,26,28,-2,4,0,-6,3
Anaheim Ducks,2014/03/23  vs. FLA,FLA,1,60,47,13,0,13,0,1,53,39,14,0,14,0,-1
Phoenix Coyotes,2013/11/23  vs. ANA,ANA,1,55,41,14,3,0,11,-4,37,32,5,4,0,1,0
New York Rangers,2014/03/28  vs. CGY,CGY,1,68,35,33,7,-2,28,15,51,30,21,8,-3,16,12
Pittsburgh Penguins,2014/02/07  vs. NYR,NYR,1,35,53,-18,-12,0,-6,-16,25,46,-21,-12,0,-9,-18
Montreal Canadiens,2014/01/02  vs. DAL,DAL,1,42,55,-13,-11,0,-2,-12,30,38,-8,-8,1,-1,-7
Buffalo Sabres,2014/02/01  vs. COL,COL,1,37,43,-6,4,0,-10,3,26,36,-10,4,0,-14,3
Toronto Maple Leafs,2014/03/13  vs. LAK,LAK,1,32,64,-32,-22,-13,3,-20,27,49,-22,-17,-6,1,-17
St. Louis Blues,2014/03/08  vs. COL,COL,1,46,44,2,-4,6,0,4,32,30,2,0,2,0,4
Edmonton Oilers,2013/10/22  vs. MTL,MTL,1,42,61,-19,-11,0,-8,-14,26,34,-8,-4,-1,-3,-3
Carolina Hurricanes,2014/01/25  vs. OTT,OTT,1,35,50,-15,-5,-10,0,-10,30,37,-7,-4,-3,0,-8
Boston Bruins,2013/10/10  vs. COL,COL,1,50,38,12,-8,0,20,5,41,24,17,-3,0,20,11
Columbus Blue Jackets,2014/01/27  vs. CAR,CAR,1,50,49,1,4,-6,3,6,35,36,-1,1,-3,1,2
Detroit Red Wings,2013/12/10  vs. FLA,FLA,1,37,42,-5,-5,0,0,-3,22,31,-9,-7,-2,0,-10
Columbus Blue Jackets,2014/03/21  vs. NYR,NYR,1,46,39,7,0,2,5,0,32,28,4,0,2,2,0
Carolina Hurricanes,2014/03/31  vs. OTT,OTT,1,49,60,-11,-6,0,-5,-11,40,45,-5,0,0,-5,-5
Florida Panthers,2014/01/21  vs. BUF,BUF,1,44,37,7,2,-3,8,17,32,33,-1,2,-3,0,9
New York Islanders,2014/04/10  vs. MTL,MTL,1,63,35,28,29,-1,0,35,42,22,20,18,2,0,20
Pittsburgh Penguins,2014/04/05  vs. MIN,MIN,1,38,30,8,4,0,4,4,24,22,2,2,0,0,3
Los Angeles Kings,2013/12/17  vs. EDM,EDM,1,63,42,21,9,12,0,8,57,31,26,9,17,0,11
Washington Capitals,2014/02/06  vs. WPG,WPG,1,44,49,-5,3,3,-11,-4,33,38,-5,3,0,-8,-5
Winnipeg Jets,2013/11/04  vs. DET,DET,1,54,33,21,6,12,3,15,39,24,15,5,10,0,9
Tampa Bay Lightning,2013/10/10  vs. FLA,FLA,1,39,26,13,2,11,0,11,26,20,6,0,6,0,6
Colorado Avalanche,2013/11/01  vs. DAL,DAL,1,34,54,-20,4,-24,0,-17,25,37,-12,3,-15,0,-10
St. Louis Blues,2013/10/09  vs. CHI,CHI,1,45,47,-2,-5,3,0,-3,37,34,3,0,3,0,2
Colorado Avalanche,2014/03/06  vs. DET,DET,1,34,55,-21,-6,0,-15,-18,27,43,-16,-5,0,-11,-14
New York Islanders,2014/01/02  vs. CHI,CHI,1,52,60,-8,-5,-3,0,-6,39,45,-6,-4,-2,0,-3
Nashville Predators,2013/11/08  vs. WPG,WPG,1,53,53,0,-2,0,2,-4,39,40,-1,-1,0,0,-4
Carolina Hurricanes,2014/04/10  vs. WSH,WSH,1,67,37,30,3,0,27,7,47,28,19,2,0,17,1
Toronto Maple Leafs,2014/01/25  vs. WPG,WPG,1,50,48,2,5,0,-3,6,33,39,-6,3,0,-9,3
Montreal Canadiens,2014/01/24  vs. DET,DET,1,41,35,6,-1,0,7,3,33,30,3,-3,0,6,0
Chicago Blackhawks,2013/12/23  vs. NJD,NJD,1,50,30,20,7,13,0,13,40,19,21,5,16,0,12
New Jersey Devils,2014/01/09  vs. DAL,DAL,1,41,38,3,5,-2,0,5,37,25,12,8,4,0,9
Anaheim Ducks,2013/10/20  vs. DAL,DAL,1,46,48,-2,-2,-2,2,-4,35,36,-1,-2,-1,2,-3
Boston Bruins,2013/11/02  vs. NYI,NYI,1,43,52,-9,-5,0,-4,-4,28,40,-12,-1,0,-11,-2
Washington Capitals,2013/12/20  vs. CAR,CAR,1,24,59,-35,-16,-18,-1,-24,20,44,-24,-12,-13,1,-15
Dallas Stars,2014/02/05  vs. SJS,SJS,1,38,50,-12,-9,0,-3,-14,24,32,-8,-6,0,-2,-10
Montreal Canadiens,2013/12/04  vs. NJD,NJD,1,35,49,-14,-4,-9,-1,-12,31,37,-6,-1,-3,-2,-5
Dallas Stars,2013/10/12  vs. MIN,MIN,1,32,50,-18,0,0,-18,-6,22,37,-15,0,0,-15,-4
Carolina Hurricanes,2014/03/13  vs. BUF,BUF,1,67,34,33,30,3,0,28,48,24,24,23,3,-2,21
Los Angeles Kings,2014/01/04  vs. VAN,VAN,1,63,33,30,7,2,21,28,52,26,26,6,1,19,24
St. Louis Blues,2013/10/03  vs. NSH,NSH,1,36,45,-9,1,-10,0,-2,30,34,-4,0,-4,0,0
St. Louis Blues,2013/12/12  vs. TOR,TOR,1,46,28,18,1,17,0,10,42,20,22,1,21,0,11
Boston Bruins,2014/03/29  vs. WSH,WSH,1,49,51,-2,15,-17,0,18,35,36,-1,9,-10,0,11
Boston Bruins,2014/03/18  vs. NJD,NJD,1,37,32,5,7,-2,0,7,28,20,8,7,1,0,7
San Jose Sharks,2013/12/23  vs. COL,COL,1,67,50,17,16,-11,12,27,47,31,16,12,-6,10,24
St. Louis Blues,2014/03/29  vs. DAL,DAL,1,47,30,17,3,0,14,10,35,26,9,2,0,7,5
Edmonton Oilers,2014/01/03  vs. ANA,ANA,1,27,40,-13,2,-3,-12,-11,20,32,-12,3,-1,-14,-7
Toronto Maple Leafs,2013/10/25  vs. CBJ,CBJ,1,26,33,-7,2,0,-9,-3,21,27,-6,4,0,-10,-1
Chicago Blackhawks,2013/11/06  vs. WPG,WPG,1,44,36,8,4,4,0,2,32,28,4,7,-3,0,6
Tampa Bay Lightning,2013/10/19  vs. BOS,BOS,1,29,26,3,0,0,3,2,24,19,5,1,0,4,5
New York Rangers,2014/01/29  vs. NYI,NYI,1,48,45,3,0,3,0,0,39,33,6,1,5,0,1
Colorado Avalanche,2014/01/25  vs. TBL,TBL,1,52,47,5,10,0,-5,11,39,32,7,8,0,-1,9
Pittsburgh Penguins,2013/10/26  vs. TOR,TOR,1,49,41,8,17,-5,-4,12,39,27,12,16,-2,-2,14
Ottawa Senators,2014/01/18  vs. NYR,NYR,1,47,42,5,-7,-1,13,-6,37,27,10,-2,0,12,-2
Edmonton Oilers,2014/03/13  vs. STL,STL,1,29,50,-21,-5,-6,-10,-20,20,36,-16,-4,-3,-9,-14
Philadelphia Flyers,2014/04/10  vs. TBL,TBL,1,49,37,12,4,0,8,15,36,28,8,0,0,8,9
St. Louis Blues,2013/11/14  vs. COL,COL,1,39,37,2,8,-6,0,1,29,28,1,3,-2,0,-2
Philadelphia Flyers,2013/10/29  vs. ANA,ANA,1,40,54,-14,-11,2,-5,-6,30,42,-12,-14,6,-4,-10
Montreal Canadiens,2013/12/05  vs. BOS,BOS,1,38,58,-20,-2,-23,5,8,28,38,-10,-3,-9,2,2
Minnesota Wild,2013/10/10  vs. WPG,WPG,1,43,23,20,11,9,0,17,34,17,17,7,10,0,15
Florida Panthers,2014/03/16  vs. VAN,VAN,1,36,47,-11,-8,3,-6,-13,26,38,-12,-8,3,-7,-13
Florida Panthers,2014/03/27  vs. CAR,CAR,1,49,41,8,0,0,8,-3,44,31,13,-1,0,14,-1
Colorado Avalanche,2014/04/10  vs. VAN,VAN,1,43,58,-15,-2,-9,-4,-6,30,45,-15,-4,-7,-4,-8
Philadelphia Flyers,2014/02/06  vs. COL,COL,1,43,52,-9,2,-11,0,0,35,32,3,7,-4,0,6
Montreal Canadiens,2014/04/12  vs. NYR,NYR,1,40,44,-4,-4,0,0,-4,26,38,-12,-12,0,0,-12
Colorado Avalanche,2014/03/02  vs. TBL,TBL,1,48,51,-3,-8,8,-3,-1,35,42,-7,-9,7,-5,-4
San Jose Sharks,2014/02/05  vs. DAL,DAL,1,50,38,12,9,3,0,14,32,24,8,6,2,0,10
Florida Panthers,2013/10/19  vs. MIN,MIN,1,25,32,-7,-2,0,-5,-4,22,23,-1,0,0,-1,-1
Colorado Avalanche,2013/11/23  vs. LAK,LAK,1,40,31,9,9,0,0,9,35,21,14,14,0,0,14
Carolina Hurricanes,2013/12/20  vs. WSH,WSH,1,59,24,35,16,1,18,24,44,20,24,12,-1,13,15
Philadelphia Flyers,2013/12/19  vs. CBJ,CBJ,1,63,31,32,8,1,23,13,45,28,17,5,1,11,6
Phoenix Coyotes,2014/04/10  vs. NSH,NSH,1,53,32,21,1,0,20,6,38,29,9,-3,0,12,-1
Montreal Canadiens,2013/12/19  vs. STL,STL,1,31,34,-3,0,0,-3,2,22,23,-1,1,0,-2,2
Calgary Flames,2013/12/15  vs. NYR,NYR,1,28,59,-31,-28,-3,0,-34,21,36,-15,-20,5,0,-21
Ottawa Senators,2014/03/31  vs. CAR,CAR,1,60,49,11,6,5,0,11,45,40,5,0,5,0,5
Nashville Predators,2014/03/28  vs. DAL,DAL,1,64,48,16,2,0,14,-6,46,33,13,-1,0,14,-7
New York Rangers,2013/12/10  vs. NSH,NSH,1,54,49,5,-1,0,6,-7,34,31,3,-3,0,6,-1
Boston Bruins,2014/01/07  vs. ANA,ANA,1,54,34,20,15,0,5,14,43,24,19,16,0,3,16
Minnesota Wild,2013/10/24  vs. CAR,CAR,1,40,41,-1,-4,3,0,-9,27,29,-2,-1,-1,0,-7
Toronto Maple Leafs,2014/01/28  vs. TBL,TBL,1,47,53,-6,0,-6,0,-11,34,43,-9,-5,-4,0,-13
Chicago Blackhawks,2014/01/05  vs. SJS,SJS,1,52,55,-3,-2,-2,1,2,39,41,-2,1,0,-3,1
Toronto Maple Leafs,2014/01/23  vs. DAL,DAL,1,41,43,-2,-7,0,5,-8,30,33,-3,-2,0,-1,-5
Chicago Blackhawks,2014/03/23  vs. NSH,NSH,1,41,17,24,12,0,12,17,27,14,13,9,0,4,11
New York Rangers,2014/02/07  vs. PIT,PIT,1,53,35,18,12,6,0,16,46,25,21,12,9,0,18
Calgary Flames,2013/10/22  vs. PHX,PHX,1,45,52,-7,-4,0,-3,-3,33,38,-5,0,0,-5,-4
Colorado Avalanche,2014/03/25  vs. NSH,NSH,1,49,52,-3,5,0,-8,-1,39,40,-1,6,0,-7,-1
Dallas Stars,2013/10/29  vs. MTL,MTL,1,57,39,18,0,0,18,1,31,31,0,-3,0,3,-7
Carolina Hurricanes,2014/02/08  vs. MTL,MTL,1,62,40,22,2,5,15,5,46,31,15,3,4,8,5
New Jersey Devils,2014/02/27  vs. CBJ,CBJ,1,42,37,5,2,3,0,2,38,28,10,3,7,0,3
Pittsburgh Penguins,2013/10/08  vs. CAR,CAR,1,47,44,3,1,2,0,4,39,34,5,2,3,0,2
Anaheim Ducks,2014/03/05  vs. MTL,MTL,1,39,48,-9,-11,-3,5,-12,28,41,-13,-13,-2,2,-13
New York Islanders,2013/10/08  vs. PHX,PHX,1,39,54,-15,1,-16,0,-7,30,48,-18,1,-19,0,-7
Nashville Predators,2014/03/11  vs. BUF,BUF,1,44,35,9,2,-3,10,16,30,26,4,0,-1,5,8
Ottawa Senators,2014/03/10  vs. NSH,NSH,1,58,57,1,-7,0,8,-10,44,47,-3,-7,0,4,-9
San Jose Sharks,2014/01/25  vs. MIN,MIN,1,61,38,23,34,0,-11,27,40,28,12,23,0,-11,16
Columbus Blue Jackets,2013/10/15  vs. DET,DET,1,40,43,-3,-6,0,3,0,32,35,-3,-8,0,5,-4
Calgary Flames,2013/10/24  vs. DAL,DAL,1,53,54,-1,-10,0,9,-8,36,45,-9,-9,0,0,-7
Pittsburgh Penguins,2013/11/22  vs. NYI,NYI,1,47,46,1,2,-1,0,-1,36,36,0,2,-2,0,-1
Chicago Blackhawks,2014/01/17  vs. ANA,ANA,1,56,31,25,8,17,0,11,40,22,18,6,12,0,7
Detroit Red Wings,2013/12/14  vs. PIT,PIT,1,37,24,13,3,1,9,9,26,21,5,2,1,2,7
Vancouver Canucks,2013/10/15  vs. PHI,PHI,1,49,43,6,1,0,5,8,33,32,1,-5,0,6,2
New York Rangers,2014/01/18  vs. OTT,OTT,1,42,47,-5,7,-13,1,6,27,37,-10,2,-12,0,2
New York Islanders,2014/01/20  vs. PHI,PHI,1,51,28,23,0,0,23,5,36,20,16,5,0,11,5
Montreal Canadiens,2014/02/06  vs. VAN,VAN,1,43,60,-17,-3,-14,0,-6,30,46,-16,-5,-11,0,-10
St. Louis Blues,2014/01/28  vs. NJD,NJD,1,38,40,-2,0,-2,0,-1,26,26,0,-1,1,0,-3
St. Louis Blues,2014/04/01  vs. PHI,PHI,1,51,37,14,14,0,0,14,38,28,10,10,0,0,10
Phoenix Coyotes,2014/02/07  vs. CHI,CHI,1,37,41,-4,0,-4,0,0,27,31,-4,0,-4,0,-1
Vancouver Canucks,2014/01/13  vs. LAK,LAK,1,22,29,-7,-4,0,-3,-4,18,18,0,1,0,-1,1
Carolina Hurricanes,2013/12/23  vs. CBJ,CBJ,1,40,39,1,-16,10,7,-8,29,28,1,-11,9,3,-6
Montreal Canadiens,2013/10/29  vs. DAL,DAL,1,39,57,-18,0,-18,0,-1,31,31,0,3,-3,0,7
Nashville Predators,2014/03/25  vs. COL,COL,1,52,49,3,-5,8,0,1,40,39,1,-6,7,0,1
Montreal Canadiens,2014/02/02  vs. WPG,WPG,1,42,55,-13,-21,0,8,-13,27,35,-8,-10,0,2,-5
Chicago Blackhawks,2014/03/25  vs. DAL,DAL,1,48,44,4,2,2,0,5,42,36,6,2,4,0,5
Nashville Predators,2014/03/23  vs. CHI,CHI,1,17,41,-24,-12,-12,0,-17,14,27,-13,-9,-4,0,-11
Toronto Maple Leafs,2014/03/11  vs. SJS,SJS,1,27,77,-50,-17,0,-33,-36,20,58,-38,-13,0,-25,-26
Ottawa Senators,2014/03/30  vs. CGY,CGY,1,61,49,12,3,8,1,3,47,41,6,0,7,-1,-2
Dallas Stars,2013/11/03  vs. OTT,OTT,1,45,44,1,2,-1,0,4,37,31,6,3,3,0,5
New York Islanders,2013/11/29  vs. DET,DET,1,56,47,9,4,0,5,3,41,37,4,4,0,0,1
Columbus Blue Jackets,2013/11/19  vs. EDM,EDM,1,38,44,-6,-1,0,-5,-11,26,35,-9,-1,0,-8,-9
Detroit Red Wings,2013/11/15  vs. WSH,WSH,1,37,33,4,2,2,0,3,31,29,2,3,2,-3,1
Winnipeg Jets,2014/03/16  vs. DAL,DAL,1,51,41,10,-2,7,5,9,34,28,6,-2,6,2,5
Philadelphia Flyers,2014/03/01  vs. NYR,NYR,1,45,55,-10,5,-15,0,-6,31,38,-7,4,-11,0,-4
Columbus Blue Jackets,2013/11/05  vs. OTT,OTT,1,41,42,-1,-5,0,4,-8,34,31,3,-2,0,5,-4
Philadelphia Flyers,2013/11/07  vs. NJD,NJD,1,34,30,4,-2,0,6,4,25,26,-1,-2,0,1,2
San Jose Sharks,2014/03/16  vs. NYR,NYR,1,47,62,-15,-12,-3,0,-9,30,46,-16,-12,-4,0,-11
Calgary Flames,2014/02/27  vs. LAK,LAK,1,35,29,6,0,0,6,9,24,22,2,-1,0,3,6
Tampa Bay Lightning,2014/01/16  vs. NYI,NYI,1,45,38,7,16,-9,0,7,37,27,10,15,-5,0,10
Edmonton Oilers,2014/02/07  vs. NJD,NJD,1,28,40,-12,-11,0,-1,-12,22,27,-5,-4,0,-1,-5
Carolina Hurricanes,2014/04/05  vs. NJD,NJD,1,42,51,-9,-7,0,-2,-3,28,38,-10,0,0,-10,-3
Pittsburgh Penguins,2014/03/15  vs. PHI,PHI,1,34,53,-19,-3,0,-16,-5,24,39,-15,-2,0,-13,-3
Winnipeg Jets,2014/03/17  vs. STL,STL,1,28,52,-24,-20,0,-4,-24,19,38,-19,-13,0,-6,-18
New York Rangers,2014/03/18  vs. OTT,OTT,1,55,65,-10,-1,-6,-3,-7,43,48,-5,-2,-1,-2,-7
Florida Panthers,2013/10/27  vs. TBL,TBL,1,44,37,7,0,0,7,1,33,30,3,-1,0,4,-2
Ottawa Senators,2013/12/19  vs. FLA,FLA,1,47,49,-2,3,-8,3,-3,40,35,5,3,0,2,4
Minnesota Wild,2014/01/09  vs. PHX,PHX,1,38,61,-23,-20,-3,0,-20,26,43,-17,-19,2,0,-18
Vancouver Canucks,2014/01/10  vs. STL,STL,1,41,49,-8,-4,-4,0,-6,26,37,-11,-9,-2,0,-10
Boston Bruins,2014/04/05  vs. PHI,PHI,1,62,40,22,10,12,0,13,47,31,16,5,11,0,8
Minnesota Wild,2013/11/19  vs. MTL,MTL,1,45,42,3,3,0,0,-5,26,33,-7,1,0,-8,-4
Columbus Blue Jackets,2014/03/28  vs. PIT,PIT,1,39,44,-5,-5,0,0,-5,35,34,1,1,0,0,1
Philadelphia Flyers,2014/03/05  vs. WSH,WSH,1,47,36,11,1,10,0,5,32,24,8,2,6,0,6
St. Louis Blues,2013/12/28  vs. CHI,CHI,1,54,41,13,-4,0,17,1,38,32,6,-2,0,8,2
Columbus Blue Jackets,2014/03/01  vs. FLA,FLA,1,36,38,-2,-2,0,0,2,31,23,8,-1,9,0,7
Pittsburgh Penguins,2014/02/03  vs. OTT,OTT,1,50,39,11,13,0,-2,11,39,30,9,11,0,-2,9
Philadelphia Flyers,2013/12/11  vs. CHI,CHI,1,35,31,4,3,3,-2,4,25,19,6,3,2,1,6
Chicago Blackhawks,2014/01/22  vs. DET,DET,1,38,44,-6,-3,0,-3,-6,30,35,-5,-1,0,-4,-5
Pittsburgh Penguins,2013/10/30  vs. BOS,BOS,1,52,40,12,3,9,0,4,42,25,17,8,9,0,11
New Jersey Devils,2014/01/28  vs. STL,STL,1,40,38,2,0,0,2,1,26,26,0,1,0,-1,3
Nashville Predators,2013/11/25  vs. PHX,PHX,1,44,50,-6,1,-7,0,4,35,37,-2,1,-3,0,3
Calgary Flames,2013/12/14  vs. BUF,BUF,1,31,45,-14,-14,0,0,-14,25,29,-4,-6,0,2,-6
Buffalo Sabres,2013/10/14  vs. MIN,MIN,1,35,29,6,-1,0,7,0,27,24,3,-1,0,4,1
Nashville Predators,2013/12/10  vs. NYR,NYR,1,49,54,-5,1,-6,0,7,31,34,-3,3,-6,0,1
Montreal Canadiens,2013/12/21  vs. NSH,NSH,1,38,52,-14,-6,-8,0,-6,32,39,-7,-4,-3,0,-3
Edmonton Oilers,2014/03/06  vs. NYI,NYI,1,39,51,-12,-2,0,-10,-6,32,41,-9,-4,0,-5,-9
Detroit Red Wings,2014/03/23  vs. MIN,MIN,1,30,43,-13,-9,-5,1,-13,24,31,-7,-6,-2,1,-11
Phoenix Coyotes,2014/03/02  vs. STL,STL,1,40,41,-1,6,-6,-1,9,27,37,-10,1,-9,-2,0
Columbus Blue Jackets,2014/03/11  vs. DET,DET,1,45,45,0,-4,8,-4,-8,36,37,-1,-2,4,-3,-5
Boston Bruins,2013/11/19  vs. NYR,NYR,1,44,69,-25,-11,-14,0,-22,27,50,-23,-9,-14,0,-18
Toronto Maple Leafs,2014/01/30  vs. FLA,FLA,1,41,50,-9,2,-6,-5,-5,34,41,-7,1,-7,-1,-7
Los Angeles Kings,2014/04/03  vs. SJS,SJS,1,59,42,17,-1,15,3,12,38,27,11,0,9,2,9
Washington Capitals,2014/04/04  vs. NJD,NJD,1,32,39,-7,-4,-2,-1,-6,26,26,0,-1,4,-3,3
Toronto Maple Leafs,2014/03/05  vs. NYR,NYR,1,38,67,-29,-18,-11,0,-27,29,46,-17,-9,-8,0,-15
Philadelphia Flyers,2014/03/30  vs. BOS,BOS,1,53,41,12,-2,1,13,2,45,29,16,-1,2,15,6
Colorado Avalanche,2013/10/21  vs. PIT,PIT,1,23,44,-21,-8,-13,0,-14,15,29,-14,-5,-9,0,-9
Detroit Red Wings,2013/10/26  vs. NYR,NYR,1,32,37,-5,1,-6,0,-5,29,35,-6,1,-7,0,-5
Winnipeg Jets,2013/10/10  vs. MIN,MIN,1,23,43,-20,-11,0,-9,-17,17,34,-17,-7,0,-10,-15
Detroit Red Wings,2014/01/09  vs. SJS,SJS,1,43,44,-1,-1,0,0,-2,28,36,-8,-1,0,-7,-7
Carolina Hurricanes,2013/12/12  vs. CGY,CGY,1,52,41,11,6,0,5,6,35,32,3,-3,0,6,-3
Florida Panthers,2014/02/07  vs. CAR,CAR,1,67,52,15,-2,0,17,-4,44,40,4,-2,0,6,-5
Minnesota Wild,2013/10/17  vs. TBL,TBL,1,36,34,2,6,0,-4,13,27,27,0,4,0,-4,8
Philadelphia Flyers,2014/03/16  vs. PIT,PIT,1,45,32,13,2,11,0,6,35,23,12,0,12,0,6
Nashville Predators,2013/10/20  vs. WPG,WPG,1,30,55,-25,-3,-22,0,-9,26,41,-15,1,-16,0,-4
New Jersey Devils,2014/03/27  vs. PHX,PHX,1,35,26,9,-4,0,13,8,28,23,5,-4,0,9,5
Detroit Red Wings,2013/11/01  vs. CGY,CGY,1,34,37,-3,1,-4,0,-5,24,27,-3,1,-4,0,-4
Florida Panthers,2013/11/27  vs. NYR,NYR,1,51,31,20,0,0,20,7,39,23,16,1,0,15,7
San Jose Sharks,2013/12/17  vs. STL,STL,1,37,41,-4,1,-5,0,5,30,24,6,0,6,0,3
Carolina Hurricanes,2013/11/24  vs. OTT,OTT,1,66,59,7,0,-9,16,15,47,48,-1,-1,-10,10,7
Montreal Canadiens,2013/11/19  vs. MIN,MIN,1,42,45,-3,-3,0,0,5,33,26,7,-1,8,0,4
Florida Panthers,2013/12/23  vs. TBL,TBL,1,31,52,-21,-1,0,-20,-3,27,42,-15,-2,0,-13,-3
Pittsburgh Penguins,2014/01/20  vs. FLA,FLA,1,39,43,-4,1,0,-5,-3,29,32,-3,4,0,-7,2
Phoenix Coyotes,2013/11/14  vs. CHI,CHI,1,43,60,-17,-10,-5,-2,-19,34,48,-14,-7,-5,-2,-16
Anaheim Ducks,2013/11/06  vs. PHX,PHX,1,38,41,-3,10,-12,-1,9,29,32,-3,6,-8,-1,5
Columbus Blue Jackets,2014/01/30  vs. WSH,WSH,1,23,28,-5,1,-6,0,2,20,16,4,1,3,0,2
Winnipeg Jets,2014/03/14  vs. NYR,NYR,1,47,30,17,3,4,10,8,32,19,13,5,3,5,9
Anaheim Ducks,2013/12/21  vs. NYI,NYI,1,52,36,16,0,2,14,10,32,27,5,-3,1,7,0
Washington Capitals,2014/01/15  vs. PIT,PIT,1,48,40,8,-5,13,0,8,34,31,3,-7,10,0,3
Toronto Maple Leafs,2013/11/16  vs. BUF,BUF,1,38,48,-10,5,-15,0,13,29,34,-5,4,-9,0,8
Buffalo Sabres,2014/01/25  vs. CBJ,CBJ,1,25,84,-59,-7,-52,0,-32,20,55,-35,0,-35,0,-17
Buffalo Sabres,2013/11/12  vs. LAK,LAK,1,26,58,-32,3,-4,-31,-28,18,44,-26,2,-2,-26,-24
Philadelphia Flyers,2014/04/01  vs. STL,STL,1,37,51,-14,-14,0,0,-14,28,38,-10,-10,0,0,-10
New York Islanders,2014/03/10  vs. VAN,VAN,1,34,34,0,-2,1,1,1,29,24,5,1,4,0,3
Edmonton Oilers,2014/03/25  vs. SJS,SJS,1,54,52,2,0,-7,9,-5,35,38,-3,-2,-9,8,-7
Ottawa Senators,2013/10/04  vs. BUF,BUF,1,63,41,22,20,2,0,20,48,36,12,10,2,0,10
Phoenix Coyotes,2014/04/13  vs. DAL,DAL,1,45,17,28,17,0,11,28,35,14,21,10,1,10,20
Anaheim Ducks,2013/10/31  vs. BOS,BOS,1,25,39,-14,-6,-8,0,-7,21,27,-6,-3,-3,0,-4
Chicago Blackhawks,2013/11/03  vs. CGY,CGY,1,72,39,33,27,2,4,29,48,32,16,14,1,1,15
Columbus Blue Jackets,2013/10/12  vs. BOS,BOS,1,39,44,-5,-11,0,6,-11,25,36,-11,-11,0,0,-11
Detroit Red Wings,2014/02/08  vs. TBL,TBL,1,52,37,15,11,4,0,15,41,28,13,7,5,1,12
Carolina Hurricanes,2013/10/13  vs. PHX,PHX,1,35,43,-8,-6,-3,1,-12,26,37,-11,-5,-3,-3,-13
Carolina Hurricanes,2014/01/04  vs. NYI,NYI,1,57,53,4,-7,11,0,-1,41,36,5,-3,8,0,2
Vancouver Canucks,2013/10/06  vs. CGY,CGY,1,52,48,4,3,-1,2,0,37,35,2,1,3,-2,-1
Washington Capitals,2014/02/04  vs. NYI,NYI,1,36,36,0,4,0,-4,4,24,20,4,6,0,-2,6
New Jersey Devils,2014/03/14  vs. FLA,FLA,1,55,30,25,8,19,-2,17,37,26,11,3,12,-4,7
St. Louis Blues,2014/04/05  vs. COL,COL,1,38,36,2,-3,0,5,-1,27,29,-2,0,0,-2,3
Pittsburgh Penguins,2014/04/12  vs. PHI,PHI,1,47,32,15,15,-4,4,9,35,25,10,10,-4,4,6
Washington Capitals,2013/11/15  vs. DET,DET,1,33,37,-4,-2,0,-2,-3,29,31,-2,-3,3,-2,-1
New York Rangers,2013/12/07  vs. NJD,NJD,1,44,46,-2,-4,3,-1,-4,26,35,-9,-7,-1,-1,-12
Dallas Stars,2013/10/19  vs. LAK,LAK,1,35,55,-20,-14,-3,-3,-17,31,39,-8,-8,-2,2,-9
St. Louis Blues,2013/12/05  vs. NYI,NYI,1,32,29,3,1,2,0,-1,26,27,-1,-1,0,0,-5
Colorado Avalanche,2013/11/06  vs. NSH,NSH,1,52,50,2,-1,0,3,-13,38,34,4,3,0,1,-6
Anaheim Ducks,2014/03/31  vs. WPG,WPG,1,54,55,-1,-6,0,5,-10,38,38,0,-7,0,7,-12
Philadelphia Flyers,2014/03/24  vs. LAK,LAK,1,45,54,-9,-10,0,1,-17,32,45,-13,-8,0,-5,-16
Colorado Avalanche,2013/10/27  vs. WPG,WPG,1,62,42,20,12,6,2,9,46,32,14,11,3,0,5
Boston Bruins,2013/12/17  vs. CGY,CGY,1,42,29,13,2,11,0,15,35,21,14,2,12,0,14
Ottawa Senators,2013/10/13  vs. ANA,ANA,1,57,55,2,0,0,2,-9,40,50,-10,-1,0,-9,-10
Florida Panthers,2013/12/28  vs. DET,DET,1,45,36,9,6,0,3,8,28,26,2,6,0,-4,6
New York Rangers,2014/03/05  vs. TOR,TOR,1,67,38,29,18,0,11,27,46,29,17,9,0,8,15
Chicago Blackhawks,2014/01/23  vs. MIN,MIN,1,52,29,23,4,0,19,0,38,22,16,2,0,14,-2
Pittsburgh Penguins,2014/01/03  vs. NYR,NYR,1,37,47,-10,-2,-8,0,-4,31,35,-4,-2,-2,0,-2
New Jersey Devils,2013/11/30  vs. BUF,BUF,1,40,22,18,18,0,0,18,30,16,14,14,0,0,14
Pittsburgh Penguins,2013/12/29  vs. CBJ,CBJ,1,26,57,-31,-21,-8,-2,-26,22,38,-16,-11,-4,-1,-15
Florida Panthers,2013/10/03  vs. DAL,DAL,1,41,51,-10,-19,4,5,-15,34,33,1,-9,5,5,-5
Philadelphia Flyers,2014/02/01  vs. LAK,LAK,1,23,58,-35,-17,-18,0,-28,17,43,-26,-10,-16,0,-19
Carolina Hurricanes,2013/11/01  vs. TBL,TBL,1,48,49,-1,2,0,-3,-2,32,37,-5,0,0,-5,-5
Philadelphia Flyers,2014/01/07  vs. NJD,NJD,1,33,38,-5,-4,0,-1,-8,29,36,-7,-3,0,-4,-10
New York Rangers,2013/12/20  vs. NYI,NYI,1,33,26,7,8,-2,1,6,22,20,2,4,-2,0,1
Florida Panthers,2014/03/13  vs. TBL,TBL,1,37,45,-8,-6,-3,1,-13,30,34,-4,-3,0,-1,-6
Toronto Maple Leafs,2013/10/02  vs. PHI,PHI,1,33,44,-11,-7,-4,0,-7,26,29,-3,-5,-2,4,-1
Minnesota Wild,2014/01/14  vs. OTT,OTT,1,44,39,5,-12,0,17,-7,32,32,0,-10,0,10,-9
Anaheim Ducks,2013/11/30  vs. SJS,SJS,1,49,44,5,-3,2,6,1,36,27,9,-1,2,8,3
New York Islanders,2014/03/01  vs. NJD,NJD,1,28,39,-11,0,0,-11,4,17,26,-9,0,0,-9,5
Edmonton Oilers,2014/04/10  vs. LAK,LAK,1,37,61,-24,0,0,-24,-5,25,45,-20,0,0,-20,-4
Chicago Blackhawks,2014/03/14  vs. NSH,NSH,1,56,42,14,-2,0,16,2,41,29,12,-1,0,13,4
Minnesota Wild,2014/01/23  vs. CHI,CHI,1,29,52,-23,-4,-19,0,0,22,38,-16,-2,-14,0,2
Los Angeles Kings,2014/03/01  vs. CAR,CAR,1,39,32,7,8,-1,0,9,35,30,5,8,-3,0,9
Philadelphia Flyers,2014/01/12  vs. NYR,NYR,1,44,48,-4,-7,0,3,-8,31,36,-5,-5,0,0,-6
Vancouver Canucks,2013/11/25  vs. LAK,LAK,1,38,37,1,-8,7,2,-6,29,26,3,-2,7,-2,-4
Ottawa Senators,2013/12/21  vs. PHX,PHX,1,42,34,8,3,5,0,13,34,25,9,3,6,0,12
Pittsburgh Penguins,2013/12/05  vs. SJS,SJS,1,47,59,-12,3,-15,0,1,32,43,-11,3,-14,0,3
Tampa Bay Lightning,2014/01/25  vs. COL,COL,1,47,52,-5,-10,5,0,-11,32,39,-7,-8,1,0,-9
Ottawa Senators,2014/03/28  vs. CHI,CHI,1,48,52,-4,-1,-3,0,4,33,42,-9,-4,-5,0,-3
Minnesota Wild,2013/11/25  vs. STL,STL,1,30,46,-16,-1,0,-15,-11,22,34,-12,-1,0,-11,-8
Vancouver Canucks,2013/10/03  vs. SJS,SJS,1,45,46,-1,5,-7,1,-1,34,32,2,2,1,-1,3
Ottawa Senators,2014/03/22  vs. DAL,DAL,1,42,57,-15,-5,-6,-4,-11,32,42,-10,-4,-3,-3,-7
Phoenix Coyotes,2014/01/11  vs. ANA,ANA,1,53,37,16,4,0,12,-1,35,33,2,-3,-3,8,-11
Buffalo Sabres,2013/12/07  vs. MTL,MTL,1,46,39,7,0,0,7,3,30,27,3,2,0,1,3
Washington Capitals,2013/12/03  vs. CAR,CAR,1,43,37,6,-1,0,7,7,33,27,6,-2,0,8,6
Nashville Predators,2013/12/28  vs. LAK,LAK,1,33,51,-18,-13,-5,0,-15,27,34,-7,-4,-3,0,-5
Florida Panthers,2013/10/10  vs. TBL,TBL,1,26,39,-13,-2,0,-11,-11,20,26,-6,0,0,-6,-6
Carolina Hurricanes,2014/01/10  vs. CBJ,CBJ,1,45,43,2,4,0,-2,1,40,32,8,4,0,4,2
New York Rangers,2013/12/08  vs. WSH,WSH,1,43,47,-4,0,0,-4,-1,30,38,-8,-1,0,-7,-2
Los Angeles Kings,2013/10/15  vs. TBL,TBL,1,44,36,8,-1,0,9,-1,35,27,8,-1,0,9,-2
Nashville Predators,2014/03/30  vs. WSH,WSH,1,40,22,18,9,8,1,16,33,18,15,7,7,1,13
Los Angeles Kings,2013/10/21  vs. CGY,CGY,1,48,34,14,15,-1,0,14,35,26,9,10,-1,0,9
Edmonton Oilers,2014/03/16  vs. CAR,CAR,1,46,52,-6,-1,-5,0,-3,38,37,1,2,-1,0,3
Tampa Bay Lightning,2013/12/21  vs. CAR,CAR,1,62,44,18,20,0,-2,19,49,33,16,20,0,-4,20
Buffalo Sabres,2013/10/04  vs. OTT,OTT,1,41,63,-22,-20,0,-2,-20,36,48,-12,-10,0,-2,-10
Dallas Stars,2014/03/29  vs. STL,STL,1,30,47,-17,-3,-14,0,-10,26,35,-9,-2,-7,0,-5
Detroit Red Wings,2014/01/18  vs. LAK,LAK,1,51,39,12,9,0,3,11,38,30,8,6,0,2,8
Los Angeles Kings,2014/04/05  vs. VAN,VAN,1,50,55,-5,-3,-1,-1,-3,38,42,-4,-3,0,-1,-3
Chicago Blackhawks,2014/01/02  vs. NYI,NYI,1,60,52,8,5,0,3,6,45,39,6,4,0,2,3
Florida Panthers,2013/10/17  vs. BOS,BOS,1,32,56,-24,-6,0,-18,-16,30,45,-15,-4,0,-11,-11
Edmonton Oilers,2014/01/12  vs. CHI,CHI,1,31,55,-24,-6,1,-19,-17,22,42,-20,-8,3,-15,-13
Anaheim Ducks,2013/10/25  vs. OTT,OTT,1,39,36,3,-2,5,0,-6,31,26,5,-3,8,0,-4
Los Angeles Kings,2013/11/27  vs. SJS,SJS,1,44,60,-16,9,-20,-5,-8,33,46,-13,5,-16,-2,-8
Philadelphia Flyers,2014/04/05  vs. BOS,BOS,1,40,62,-22,-10,0,-12,-13,31,47,-16,-5,0,-11,-8
Tampa Bay Lightning,2013/10/17  vs. MIN,MIN,1,34,36,-2,-6,4,0,-13,27,27,0,-4,4,0,-8
Los Angeles Kings,2014/01/09  vs. BOS,BOS,1,46,35,11,0,11,0,3,38,29,9,3,6,0,6
Ottawa Senators,2013/10/29  vs. CHI,CHI,1,48,52,-4,6,-1,-9,1,42,44,-2,7,-2,-7,2
Philadelphia Flyers,2013/11/25  vs. FLA,FLA,1,47,40,7,1,0,6,-1,32,31,1,1,0,0,-2
Philadelphia Flyers,2014/04/03  vs. CBJ,CBJ,1,49,44,5,10,0,-5,11,32,33,-1,6,0,-7,6
Los Angeles Kings,2014/01/16  vs. STL,STL,1,29,32,-3,2,-5,0,0,25,26,-1,-1,0,0,1
Nashville Predators,2013/11/06  vs. COL,COL,1,50,52,-2,1,-3,0,13,34,38,-4,-3,-1,0,6
Chicago Blackhawks,2014/04/09  vs. MTL,MTL,1,50,43,7,3,0,4,3,31,36,-5,-7,0,2,-7
Nashville Predators,2013/12/27  vs. DAL,DAL,1,55,53,2,1,0,1,-7,43,40,3,1,0,2,-5
Edmonton Oilers,2014/01/18  vs. WPG,WPG,1,32,48,-16,-8,-4,-4,-14,22,37,-15,-8,-4,-3,-12
Phoenix Coyotes,2014/03/27  vs. NJD,NJD,1,26,35,-9,4,-13,0,-8,23,28,-5,4,-9,0,-5
Washington Capitals,2013/10/16  vs. NYR,NYR,1,40,49,-9,-8,0,-1,-11,25,39,-14,-10,0,-4,-11
Nashville Predators,2013/10/03  vs. STL,STL,1,45,36,9,-1,0,10,2,34,30,4,0,0,4,0
St. Louis Blues,2013/11/05  vs. MTL,MTL,1,63,34,29,19,3,7,23,32,25,7,5,-2,4,3
Vancouver Canucks,2014/04/07  vs. ANA,ANA,1,52,32,20,4,0,16,10,33,21,12,3,0,9,4
New York Rangers,2014/04/03  vs. COL,COL,1,26,34,-8,1,-9,0,3,24,29,-5,1,-6,0,3
Winnipeg Jets,2014/03/24  vs. DAL,DAL,1,51,36,15,5,0,10,6,35,26,9,4,0,5,4
Phoenix Coyotes,2013/10/31  vs. NSH,NSH,1,49,63,-14,-9,0,-5,-13,32,51,-19,-10,0,-9,-13
Dallas Stars,2013/11/07  vs. DET,DET,1,32,39,-7,-5,0,-2,-2,27,34,-7,-4,0,-3,-2
Buffalo Sabres,2014/01/27  vs. PIT,PIT,1,31,42,-11,-10,0,-1,-10,25,37,-12,-9,0,-3,-10
Philadelphia Flyers,2014/03/26  vs. NYR,NYR,1,46,51,-5,1,0,-6,3,30,39,-9,0,0,-9,2
Detroit Red Wings,2013/12/30  vs. NSH,NSH,1,51,39,12,2,0,10,0,35,33,2,1,0,1,-1
Pittsburgh Penguins,2014/02/01  vs. PHX,PHX,1,45,49,-4,-2,0,-2,2,29,32,-3,0,0,-3,-1
Philadelphia Flyers,2013/10/05  vs. MTL,MTL,1,25,45,-20,0,0,-20,-9,16,31,-15,1,0,-16,-6
Toronto Maple Leafs,2014/04/12  vs. OTT,OTT,1,37,57,-20,-8,0,-12,-12,31,36,-5,-3,0,-2,-2
Nashville Predators,2013/12/03  vs. VAN,VAN,1,40,40,0,3,0,-3,3,32,27,5,6,0,-1,6
Winnipeg Jets,2014/01/25  vs. TOR,TOR,1,48,50,-2,-5,3,0,-6,39,33,6,-3,9,0,-3
Pittsburgh Penguins,2013/11/09  vs. STL,STL,1,28,46,-18,-19,0,1,-19,20,38,-18,-18,0,0,-18
Calgary Flames,2013/10/06  vs. VAN,VAN,1,48,52,-4,-3,-2,1,0,35,37,-2,-1,2,-3,1
Chicago Blackhawks,2014/03/09  vs. BUF,BUF,1,42,22,20,16,4,0,15,28,16,12,9,3,0,9
Columbus Blue Jackets,2013/11/01  vs. PIT,PIT,1,45,43,2,0,0,2,-3,35,32,3,1,0,2,0
Detroit Red Wings,2013/12/17  vs. ANA,ANA,1,30,37,-7,-3,1,-5,-6,24,27,-3,-3,1,-1,-4
Calgary Flames,2014/01/28  vs. CHI,CHI,1,36,65,-29,-26,-3,0,-28,28,42,-14,-13,-1,0,-14
Toronto Maple Leafs,2014/03/16  vs. WSH,WSH,1,35,50,-15,-1,0,-14,0,25,36,-11,0,0,-11,0
Montreal Canadiens,2013/11/30  vs. TOR,TOR,1,47,48,-1,0,-1,0,-2,37,34,3,0,3,0,-2
Buffalo Sabres,2013/12/10  vs. OTT,OTT,1,39,54,-15,-10,0,-5,-15,33,41,-8,-5,0,-3,-8
Dallas Stars,2014/01/25  vs. PIT,PIT,1,40,39,1,11,-10,0,15,28,24,4,8,-4,0,10
Columbus Blue Jackets,2014/01/17  vs. WSH,WSH,1,42,36,6,-1,7,0,3,36,26,10,-1,11,0,2
New York Rangers,2013/12/23  vs. TOR,TOR,1,44,30,14,13,1,0,13,36,24,12,10,2,0,10
Winnipeg Jets,2013/12/07  vs. TBL,TBL,1,35,50,-15,-15,0,0,-15,29,40,-11,-13,2,0,-11
Phoenix Coyotes,2014/01/02  vs. CBJ,CBJ,1,42,42,0,-21,0,21,-20,32,34,-2,-18,0,16,-17
Philadelphia Flyers,2014/01/25  vs. BOS,BOS,1,41,49,-8,-2,0,-6,4,26,32,-6,0,0,-6,6
Florida Panthers,2013/11/22  vs. CGY,CGY,1,52,26,26,3,13,10,15,31,18,13,2,5,6,7
Ottawa Senators,2013/11/07  vs. MTL,MTL,1,33,42,-9,-5,-4,0,-4,22,28,-6,-3,-3,0,-2
Toronto Maple Leafs,2014/03/18  vs. DET,DET,1,46,43,3,-1,0,4,-2,34,34,0,-1,0,1,-1
Dallas Stars,2014/03/25  vs. CHI,CHI,1,44,48,-4,-2,0,-2,-5,36,42,-6,-2,0,-4,-5
New York Islanders,2013/12/07  vs. LAK,LAK,1,23,35,-12,2,0,-14,-3,17,23,-6,0,0,-6,-2
Tampa Bay Lightning,2014/03/17  vs. VAN,VAN,1,46,36,10,1,9,0,6,34,25,9,0,9,0,7
Boston Bruins,2013/11/29  vs. NYR,NYR,1,48,27,21,8,2,11,19,35,21,14,4,3,7,12
Washington Capitals,2013/11/01  vs. PHI,PHI,1,41,37,4,-4,8,0,0,32,26,6,-3,9,0,2
Colorado Avalanche,2013/12/05  vs. EDM,EDM,1,47,28,19,4,0,15,11,36,23,13,2,0,11,6
Minnesota Wild,2013/12/05  vs. CHI,CHI,1,33,35,-2,0,-10,8,-7,23,22,1,0,-5,6,-3
Calgary Flames,2013/12/06  vs. COL,COL,1,36,52,-16,-3,-13,0,-17,26,35,-9,-1,-11,3,-13
Winnipeg Jets,2013/12/14  vs. DAL,DAL,1,48,40,8,-2,0,10,4,33,29,4,-1,0,5,-1
Calgary Flames,2013/11/22  vs. FLA,FLA,1,26,52,-26,-3,-10,-13,-15,18,31,-13,-2,-6,-5,-7
Minnesota Wild,2013/10/08  vs. NSH,NSH,1,44,25,19,1,0,18,12,34,22,12,1,0,11,8
Buffalo Sabres,2013/11/19  vs. STL,STL,1,44,49,-5,-6,-2,3,-8,31,36,-5,-6,-2,3,-7
Chicago Blackhawks,2014/02/07  vs. PHX,PHX,1,41,37,4,0,0,4,0,31,27,4,0,0,4,1
San Jose Sharks,2014/02/07  vs. CBJ,CBJ,1,58,30,28,4,24,0,15,49,21,28,4,24,0,15
Toronto Maple Leafs,2013/12/17  vs. FLA,FLA,1,50,43,7,1,0,6,5,37,33,4,0,0,4,2
Detroit Red Wings,2014/01/24  vs. MTL,MTL,1,35,41,-6,1,-7,0,-3,30,33,-3,3,-6,0,0
Ottawa Senators,2013/10/15  vs. PHX,PHX,1,52,48,4,7,-6,3,4,42,40,2,9,-6,-1,3
Anaheim Ducks,2014/01/30  vs. PHI,PHI,1,49,46,3,-2,5,0,1,41,33,8,0,8,0,5
Carolina Hurricanes,2013/11/18  vs. BOS,BOS,1,40,58,-18,0,0,-18,-8,32,39,-7,0,0,-7,-2
Tampa Bay Lightning,2013/12/05  vs. OTT,OTT,1,31,47,-16,-5,-11,0,-8,27,36,-9,-4,-5,0,-6
Boston Bruins,2014/03/04  vs. FLA,FLA,1,44,46,-2,4,-6,0,4,33,35,-2,4,-6,0,4
St. Louis Blues,2013/12/21  vs. EDM,EDM,1,41,43,-2,-15,13,0,-10,28,26,2,-11,13,0,-8
Carolina Hurricanes,2013/10/24  vs. MIN,MIN,1,41,40,1,4,0,-3,9,29,27,2,1,0,1,7
Columbus Blue Jackets,2013/10/22  vs. NJD,NJD,1,30,42,-12,-12,3,-3,-14,23,30,-7,-10,2,1,-8
Pittsburgh Penguins,2014/03/30  vs. CHI,CHI,1,36,62,-26,-1,-25,0,-11,25,47,-22,0,-22,0,-6
Montreal Canadiens,2013/12/29  vs. FLA,FLA,1,31,43,-12,-5,0,-7,-15,25,33,-8,-3,0,-5,-9
Pittsburgh Penguins,2014/04/03  vs. WPG,WPG,1,37,28,9,1,5,3,7,26,22,4,0,6,-2,1
San Jose Sharks,2013/11/23  vs. NJD,NJD,1,50,37,13,5,8,0,9,35,22,13,2,11,0,7
Montreal Canadiens,2013/12/28  vs. TBL,TBL,1,42,44,-2,-3,1,0,-2,37,31,6,5,1,0,6
Pittsburgh Penguins,2014/03/04  vs. NSH,NSH,1,32,37,-5,-2,-3,0,-2,20,24,-4,0,-4,0,0
St. Louis Blues,2014/03/23  vs. PIT,PIT,1,44,46,-2,0,-2,0,0,34,25,9,9,0,0,9
New York Rangers,2014/01/06  vs. CBJ,CBJ,1,46,43,3,-8,0,11,-6,38,32,6,-2,0,8,1
Tampa Bay Lightning,2013/12/29  vs. NYR,NYR,1,58,37,21,-2,2,21,3,45,28,17,-1,1,17,2
Los Angeles Kings,2013/10/17  vs. NSH,NSH,1,36,49,-13,-12,0,-1,-13,24,36,-12,-10,0,-2,-12
Toronto Maple Leafs,2014/02/06  vs. TBL,TBL,1,50,70,-20,-18,-2,0,-22,42,52,-10,-11,1,0,-12
Pittsburgh Penguins,2013/11/16  vs. NJD,NJD,1,31,30,1,-4,0,5,-3,24,25,-1,-3,0,2,-3
Buffalo Sabres,2014/04/10  vs. NYR,NYR,1,29,47,-18,-5,-13,0,-18,23,32,-9,3,-12,0,-9
Dallas Stars,2014/02/04  vs. PHX,PHX,1,45,56,-11,-1,-10,0,-1,35,40,-5,0,-4,-1,-1
Florida Panthers,2013/10/11  vs. PIT,PIT,1,37,50,-13,-5,-8,0,-5,29,38,-9,-1,-8,0,-1
Nashville Predators,2014/03/14  vs. CHI,CHI,1,42,56,-14,2,-16,0,-2,29,41,-12,1,-13,0,-4
Toronto Maple Leafs,2014/04/01  vs. CGY,CGY,1,50,54,-4,-4,0,0,-3,35,44,-9,-4,-5,0,-7
Chicago Blackhawks,2013/11/09  vs. DAL,DAL,1,44,52,-8,2,-7,-3,-1,32,36,-4,7,-4,-7,1
Calgary Flames,2014/01/14  vs. NSH,NSH,1,40,44,-4,-8,0,4,-2,28,32,-4,-6,0,2,-2
Pittsburgh Penguins,2013/10/28  vs. CAR,CAR,1,46,34,12,10,2,0,11,38,24,14,9,5,0,11
New York Islanders,2013/11/12  vs. NSH,NSH,1,55,52,3,12,-9,0,16,34,38,-4,4,-8,0,8
Calgary Flames,2014/01/11  vs. PIT,PIT,1,34,35,-1,-4,0,3,-1,27,25,2,-3,0,5,-2
Carolina Hurricanes,2013/11/29  vs. NJD,NJD,1,28,48,-20,-11,-2,-7,-12,18,35,-17,-11,2,-8,-12
Nashville Predators,2014/02/01  vs. STL,STL,1,54,48,6,3,1,2,6,42,35,7,2,1,4,5
Columbus Blue Jackets,2013/11/09  vs. NYI,NYI,1,37,37,0,-2,2,0,-1,25,29,-4,-4,0,0,-4
Phoenix Coyotes,2014/03/10  vs. TBL,TBL,1,46,44,2,7,-4,-1,7,33,27,6,6,-2,2,8
Chicago Blackhawks,2014/03/18  vs. PHI,PHI,1,33,49,-16,-11,-5,0,-14,25,37,-12,-7,-5,0,-10
Dallas Stars,2013/12/10  vs. CHI,CHI,1,42,44,-2,1,0,-3,-1,29,33,-4,0,0,-4,-3
Nashville Predators,2013/12/14  vs. SJS,SJS,1,32,45,-13,0,-13,0,0,23,35,-12,0,-12,0,0
Toronto Maple Leafs,2014/01/21  vs. COL,COL,1,38,54,-16,-5,-11,0,-10,29,42,-13,-3,-10,0,-4
Vancouver Canucks,2013/11/02  vs. TOR,TOR,1,54,27,27,10,17,0,9,44,19,25,10,15,0,7
Montreal Canadiens,2013/11/23  vs. PIT,PIT,1,41,48,-7,5,-12,0,-2,27,36,-9,2,-11,0,-3
New York Rangers,2014/03/13  vs. MIN,MIN,1,39,33,6,-3,0,9,-8,27,26,1,-3,0,4,-8
Edmonton Oilers,2013/12/07  vs. CGY,CGY,1,46,26,20,12,0,8,15,27,21,6,7,0,-1,8
Detroit Red Wings,2014/01/04  vs. DAL,DAL,1,39,63,-24,-3,-21,0,-3,29,47,-18,-4,-14,0,-3
New York Rangers,2013/10/08  vs. SJS,SJS,1,46,82,-36,-12,0,-24,-29,33,62,-29,-9,0,-20,-23
Carolina Hurricanes,2013/11/12  vs. COL,COL,1,58,57,1,11,-10,0,0,46,42,4,8,-4,0,3
Philadelphia Flyers,2014/01/08  vs. MTL,MTL,1,44,39,5,4,1,0,9,34,23,11,5,6,0,9
Los Angeles Kings,2013/11/19  vs. TBL,TBL,1,42,29,13,5,8,0,6,37,25,12,4,8,0,5
Florida Panthers,2013/11/21  vs. EDM,EDM,1,43,39,4,1,0,3,-5,29,33,-4,1,0,-5,-4
New York Islanders,2013/10/15  vs. BUF,BUF,1,57,49,8,10,-2,0,7,44,37,7,8,-1,0,6
Edmonton Oilers,2014/04/12  vs. VAN,VAN,1,38,59,-21,-2,-19,0,-6,25,45,-20,-1,-19,0,-7
St. Louis Blues,2014/03/19  vs. CHI,CHI,1,38,45,-7,-4,0,-3,-8,28,37,-9,-5,0,-4,-9
Carolina Hurricanes,2014/03/18  vs. CBJ,CBJ,1,19,62,-43,-1,-42,0,-16,14,48,-34,-1,-33,0,-12
Nashville Predators,2013/11/21  vs. TOR,TOR,1,40,38,2,1,1,0,1,29,33,-4,-3,-1,0,-3
Colorado Avalanche,2014/02/26  vs. LAK,LAK,1,38,37,1,-10,-2,13,-9,28,27,1,-7,-2,10,-8
St. Louis Blues,2013/10/29  vs. WPG,WPG,1,44,30,14,11,3,0,13,34,24,10,7,3,0,9
Colorado Avalanche,2013/11/16  vs. FLA,FLA,1,51,40,11,-1,0,12,6,42,32,10,2,0,8,6
Edmonton Oilers,2013/10/24  vs. WSH,WSH,1,42,37,5,-1,0,6,1,33,31,2,-2,0,4,-2
Columbus Blue Jackets,2013/12/14  vs. STL,STL,1,38,46,-8,3,-6,-5,0,26,32,-6,2,-6,-2,3
New York Rangers,2013/12/15  vs. CGY,CGY,1,59,28,31,28,0,3,34,36,21,15,20,0,-5,21
Boston Bruins,2013/11/21  vs. STL,STL,1,59,43,16,16,1,-1,16,38,28,10,10,1,-1,10
Edmonton Oilers,2014/01/29  vs. SJS,SJS,1,26,83,-57,-15,-42,0,-41,21,66,-45,-12,-33,0,-36
St. Louis Blues,2014/03/13  vs. EDM,EDM,1,50,29,21,5,10,6,20,36,20,16,4,9,3,14
Columbus Blue Jackets,2014/04/11  vs. TBL,TBL,1,47,39,8,-2,0,10,-1,33,32,1,-4,0,5,-4
Calgary Flames,2013/10/09  vs. MTL,MTL,1,41,52,-11,0,-11,0,-9,29,41,-12,-3,-9,0,-9
Pittsburgh Penguins,2013/12/09  vs. CBJ,CBJ,1,43,60,-17,-7,-10,0,-8,31,41,-10,-5,-5,0,-6
Carolina Hurricanes,2014/03/25  vs. NYI,NYI,1,48,42,6,-6,0,12,-2,35,35,0,-5,0,5,-5
Toronto Maple Leafs,2014/01/07  vs. NYI,NYI,1,37,41,-4,-5,0,1,-7,31,32,-1,-3,2,0,-4
Nashville Predators,2013/10/22  vs. MIN,MIN,1,39,60,-21,-18,0,-3,-19,23,41,-18,-18,0,0,-18
Vancouver Canucks,2014/01/26  vs. PHX,PHX,1,46,35,11,14,-3,0,11,29,26,3,0,3,0,0
Vancouver Canucks,2013/12/03  vs. NSH,NSH,1,40,40,0,-3,3,0,-3,27,32,-5,-6,1,0,-6
Boston Bruins,2014/03/01  vs. WSH,WSH,1,48,24,24,3,0,21,3,37,19,18,0,0,18,1
Vancouver Canucks,2014/04/13  vs. CGY,CGY,1,48,38,10,-3,13,0,-3,28,26,2,-4,6,0,-3
Carolina Hurricanes,2013/11/09  vs. MIN,MIN,1,46,47,-1,2,-1,-2,-1,36,30,6,6,1,-1,6
Tampa Bay Lightning,2014/02/27  vs. NSH,NSH,1,27,39,-12,-5,-3,-4,-3,19,29,-10,-8,1,-3,-7
Anaheim Ducks,2013/12/31  vs. SJS,SJS,1,47,43,4,5,-1,0,13,37,33,4,2,2,0,9
Pittsburgh Penguins,2013/12/19  vs. MIN,MIN,1,48,38,10,1,9,0,7,37,30,7,1,6,0,3
Washington Capitals,2014/03/10  vs. PIT,PIT,1,53,36,17,6,0,11,10,37,25,12,5,0,7,12
Boston Bruins,2013/11/05  vs. DAL,DAL,1,44,40,4,-1,4,1,0,30,35,-5,-9,4,0,-9
St. Louis Blues,2013/11/25  vs. MIN,MIN,1,46,30,16,1,15,0,11,34,22,12,1,11,0,8
Anaheim Ducks,2014/01/09  vs. NSH,NSH,1,45,28,17,3,2,12,4,32,23,9,0,0,9,2
Boston Bruins,2014/01/11  vs. SJS,SJS,1,48,56,-8,-2,-6,0,-2,30,41,-11,-9,-2,0,-9
Chicago Blackhawks,2013/12/03  vs. DAL,DAL,1,70,30,40,11,0,29,16,52,23,29,9,0,20,11
New York Islanders,2014/02/06  vs. CGY,CGY,1,46,41,5,3,0,2,4,33,28,5,6,0,-1,7
Washington Capitals,2014/03/20  vs. LAK,LAK,1,33,47,-14,-1,0,-13,-6,24,33,-9,1,0,-10,-2
New York Islanders,2013/12/05  vs. STL,STL,1,29,32,-3,-1,0,-2,1,27,26,1,1,0,0,5
Colorado Avalanche,2014/01/04  vs. SJS,SJS,1,27,48,-21,-15,-6,0,-12,22,32,-10,-10,0,0,-8
San Jose Sharks,2013/10/27  vs. OTT,OTT,1,38,52,-14,2,-16,0,-9,31,39,-8,1,-9,0,-4
Minnesota Wild,2013/11/13  vs. TOR,TOR,1,54,24,30,20,0,10,33,41,17,24,16,0,8,26
Columbus Blue Jackets,2014/03/03  vs. TOR,TOR,1,60,47,13,5,8,0,3,43,36,7,1,6,0,0
Minnesota Wild,2013/12/22  vs. NYR,NYR,1,38,42,-4,1,6,-11,-2,26,41,-15,-3,3,-15,-9
Buffalo Sabres,2013/11/27  vs. MTL,MTL,1,39,42,-3,-8,0,5,-7,26,32,-6,-4,0,-2,-5
Ottawa Senators,2013/11/03  vs. DAL,DAL,1,44,45,-1,-2,0,1,-4,31,37,-6,-3,0,-3,-5
St. Louis Blues,2013/12/14  vs. CBJ,CBJ,1,46,38,8,-3,5,6,0,32,26,6,-2,2,6,-3
New York Islanders,2013/11/09  vs. CBJ,CBJ,1,37,37,0,2,0,-2,1,29,25,4,4,0,0,4
Buffalo Sabres,2013/12/17  vs. WPG,WPG,1,46,52,-6,17,-8,-15,9,36,41,-5,14,-8,-11,9
San Jose Sharks,2013/12/29  vs. ANA,ANA,1,48,68,-20,5,-25,0,4,35,39,-4,3,-7,0,2
Dallas Stars,2014/03/16  vs. WPG,WPG,1,41,51,-10,2,-5,-7,-9,28,34,-6,2,-2,-6,-5
San Jose Sharks,2014/03/29  vs. COL,COL,1,66,26,40,-4,0,44,24,47,23,24,-6,0,30,16
San Jose Sharks,2014/03/14  vs. NYI,NYI,1,45,52,-7,-4,-3,0,-11,36,41,-5,-2,-3,0,-8
Buffalo Sabres,2014/01/21  vs. FLA,FLA,1,37,44,-7,-2,-8,3,-17,33,32,1,-2,0,3,-9
Vancouver Canucks,2014/03/08  vs. CGY,CGY,1,53,49,4,12,-5,-3,9,26,25,1,5,-2,-2,3
Dallas Stars,2014/04/01  vs. WSH,WSH,1,45,51,-6,-2,-4,0,4,38,34,4,1,3,0,7
Minnesota Wild,2014/03/29  vs. PHX,PHX,1,38,45,-7,4,-2,-9,-6,30,28,2,4,0,-2,0
Philadelphia Flyers,2014/03/22  vs. STL,STL,1,40,43,-3,3,1,-7,-3,21,30,-9,-1,-3,-5,-7
Minnesota Wild,2013/10/15  vs. TOR,TOR,1,51,22,29,0,0,29,13,38,14,24,0,0,24,10
Toronto Maple Leafs,2014/01/10  vs. WSH,WSH,1,50,50,0,-2,3,-1,-3,36,36,0,1,3,-4,0
Colorado Avalanche,2014/02/04  vs. NYR,NYR,1,47,61,-14,-13,0,-1,-17,32,48,-16,-12,0,-4,-16
Dallas Stars,2014/01/20  vs. NSH,NSH,1,59,36,23,4,2,17,9,47,24,23,3,3,17,7
Boston Bruins,2014/02/06  vs. STL,STL,1,44,30,14,6,0,8,6,34,25,9,3,0,6,3
Ottawa Senators,2014/02/08  vs. BOS,BOS,1,30,60,-30,-2,0,-28,-4,25,52,-27,-2,0,-25,-3
Los Angeles Kings,2013/12/10  vs. MTL,MTL,1,52,44,8,6,2,0,1,35,31,4,5,-1,0,0
Anaheim Ducks,2014/01/18  vs. STL,STL,1,36,58,-22,-1,-21,0,-4,26,42,-16,1,-17,0,-3
Minnesota Wild,2013/11/20  vs. OTT,OTT,1,35,54,-19,-7,-3,-9,-16,29,37,-8,-3,2,-7,-8
Tampa Bay Lightning,2013/12/19  vs. NSH,NSH,1,54,34,20,2,18,0,11,39,28,11,0,11,0,7
New York Islanders,2014/03/04  vs. WPG,WPG,1,46,47,-1,6,-10,3,0,33,33,0,6,-7,1,1
Dallas Stars,2013/10/17  vs. SJS,SJS,1,47,56,-9,-8,0,-1,-9,33,38,-5,-3,0,-2,-5
Washington Capitals,2014/03/16  vs. TOR,TOR,1,50,35,15,1,14,0,0,36,25,11,0,11,0,0
Philadelphia Flyers,2013/12/31  vs. CGY,CGY,1,33,53,-20,-5,-15,0,-10,27,32,-5,-6,1,0,-3
St. Louis Blues,2013/12/02  vs. LAK,LAK,1,37,41,-4,-8,0,4,-8,32,32,0,-9,0,9,-9
Pittsburgh Penguins,2013/12/21  vs. CGY,CGY,1,35,40,-5,3,-8,0,2,21,28,-7,-2,-5,0,-3
Washington Capitals,2013/10/01  vs. CHI,CHI,1,34,42,-8,-6,-1,-1,-2,21,30,-9,-1,0,-8,-4
Winnipeg Jets,2014/03/19  vs. COL,COL,1,47,40,7,5,-1,3,7,37,30,7,4,2,1,6
Chicago Blackhawks,2014/01/12  vs. EDM,EDM,1,55,31,24,6,19,-1,17,42,22,20,8,15,-3,13
Boston Bruins,2014/01/25  vs. PHI,PHI,1,49,41,8,2,6,0,-4,32,26,6,0,6,0,-6
Chicago Blackhawks,2014/01/26  vs. WPG,WPG,1,52,41,11,-7,17,1,13,42,33,9,-6,15,0,11
Nashville Predators,2014/02/08  vs. ANA,ANA,1,47,41,6,7,1,-2,10,36,28,8,3,1,4,7
Toronto Maple Leafs,2014/03/23  vs. NJD,NJD,1,28,35,-7,-1,0,-6,-4,20,31,-11,-2,0,-9,-6
Ottawa Senators,2014/02/27  vs. DET,DET,1,47,27,20,6,0,14,6,38,24,14,4,0,10,3
Calgary Flames,2014/02/06  vs. NYI,NYI,1,41,46,-5,-3,-2,0,-4,28,33,-5,-6,1,0,-7
Los Angeles Kings,2013/12/02  vs. STL,STL,1,41,37,4,8,-4,0,8,32,32,0,9,-9,0,9
Tampa Bay Lightning,2014/04/11  vs. CBJ,CBJ,1,39,47,-8,2,-10,0,1,32,33,-1,4,-5,0,4
Edmonton Oilers,2014/03/30  vs. NYR,NYR,1,26,42,-16,-9,0,-7,-17,20,34,-14,-7,0,-7,-12
Edmonton Oilers,2013/12/28  vs. PHI,PHI,1,26,57,-31,-8,-23,0,-18,20,42,-22,-4,-18,0,-11
Chicago Blackhawks,2013/11/14  vs. PHX,PHX,1,60,43,17,10,2,5,19,48,34,14,7,2,5,16
Edmonton Oilers,2014/02/01  vs. BOS,BOS,1,32,54,-22,-13,0,-9,-11,29,43,-14,-7,0,-7,-5
Toronto Maple Leafs,2013/10/29  vs. EDM,EDM,1,42,65,-23,-2,-21,0,-7,31,45,-14,-1,-13,0,-3
Winnipeg Jets,2013/12/29  vs. COL,COL,1,54,55,-1,-2,1,0,-2,42,37,5,4,1,0,4
Colorado Avalanche,2013/12/21  vs. LAK,LAK,1,46,57,-11,-11,0,0,-13,35,46,-11,-8,0,-3,-9
Detroit Red Wings,2013/11/02  vs. EDM,EDM,1,43,30,13,0,13,0,2,30,19,11,1,10,0,3
New York Islanders,2014/04/01  vs. FLA,FLA,1,57,41,16,7,9,0,6,40,24,16,8,8,0,8
Detroit Red Wings,2014/03/11  vs. CBJ,CBJ,1,45,45,0,4,4,-8,8,37,36,1,2,3,-4,5
Edmonton Oilers,2013/10/10  vs. MTL,MTL,1,46,45,1,-1,-1,3,5,31,27,4,1,0,3,4
Florida Panthers,2014/03/09  vs. BOS,BOS,1,30,50,-20,-16,-2,-2,-18,21,39,-18,-14,-1,-3,-15
New York Rangers,2014/01/26  vs. NJD,NJD,1,34,41,-7,6,-8,-5,1,29,30,-1,8,-4,-5,2
New York Rangers,2013/11/23  vs. NSH,NSH,1,50,28,22,10,12,0,20,42,24,18,11,7,0,17
New York Rangers,2013/10/19  vs. NJD,NJD,1,29,24,5,-2,0,7,1,21,20,1,-2,0,3,0
Ottawa Senators,2014/02/04  vs. STL,STL,1,41,48,-7,-6,0,-1,-7,32,38,-6,-6,0,0,-3
Winnipeg Jets,2014/03/10  vs. COL,COL,1,49,37,12,3,2,7,12,38,29,9,3,2,4,9
Anaheim Ducks,2013/11/29  vs. CGY,CGY,1,58,44,14,4,10,0,4,47,34,13,3,10,0,3
Pittsburgh Penguins,2014/04/06  vs. COL,COL,1,45,44,1,-2,3,0,-1,37,33,4,-1,5,0,0
Colorado Avalanche,2013/10/04  vs. NSH,NSH,1,47,33,14,-1,15,0,1,39,25,14,-1,15,0,2
Calgary Flames,2013/11/29  vs. ANA,ANA,1,44,58,-14,-4,0,-10,-4,34,47,-13,-3,0,-10,-3
New York Islanders,2014/02/08  vs. COL,COL,1,45,32,13,11,0,2,16,36,27,9,12,0,-3,16
Vancouver Canucks,2014/04/10  vs. COL,COL,1,58,43,15,2,4,9,6,45,30,15,4,4,7,8
Philadelphia Flyers,2014/03/28  vs. TOR,TOR,1,48,40,8,1,7,0,1,32,29,3,0,3,0,-2
Carolina Hurricanes,2013/12/01  vs. VAN,VAN,1,44,36,8,-3,0,11,4,30,27,3,-3,0,6,3
St. Louis Blues,2014/03/25  vs. TOR,TOR,1,71,34,37,15,9,13,32,59,25,34,14,9,11,26
Detroit Red Wings,2013/10/21  vs. SJS,SJS,1,43,28,15,15,0,0,15,35,23,12,12,0,0,12
Toronto Maple Leafs,2014/01/18  vs. MTL,MTL,1,45,50,-5,9,-14,0,6,33,38,-5,5,-10,0,3
Philadelphia Flyers,2013/11/27  vs. TBL,TBL,1,34,49,-15,-15,0,0,-15,25,40,-15,-12,0,-3,-13
Montreal Canadiens,2014/03/16  vs. BUF,BUF,1,44,38,6,4,2,0,6,37,30,7,5,2,0,7
Vancouver Canucks,2014/02/08  vs. TOR,TOR,1,40,53,-13,7,-21,1,-3,31,34,-3,7,-9,-1,4
Minnesota Wild,2014/03/11  vs. EDM,EDM,1,38,29,9,5,4,0,5,31,24,7,3,4,0,2
Tampa Bay Lightning,2014/01/03  vs. CGY,CGY,1,40,41,-1,6,-7,0,11,29,25,4,4,0,0,9
Florida Panthers,2014/03/01  vs. CBJ,CBJ,1,38,36,2,2,0,0,-2,23,31,-8,1,0,-9,-7
Buffalo Sabres,2013/11/21  vs. PHI,PHI,1,32,44,-12,-3,-11,2,-14,23,36,-13,-3,-9,-1,-13
St. Louis Blues,2013/11/01  vs. FLA,FLA,1,40,47,-7,-5,-2,0,5,30,35,-5,-4,-1,0,3
Washington Capitals,2014/01/17  vs. CBJ,CBJ,1,36,42,-6,1,0,-7,-3,26,36,-10,1,0,-11,-2
Washington Capitals,2014/03/05  vs. PHI,PHI,1,36,47,-11,-1,0,-10,-5,24,32,-8,-2,0,-6,-6
Calgary Flames,2013/10/03  vs. WSH,WSH,1,43,55,-12,5,-17,0,3,33,40,-7,6,-13,0,6
Chicago Blackhawks,2014/02/27  vs. NYR,NYR,1,45,33,12,-4,0,16,-4,29,29,0,-3,0,3,-5
New Jersey Devils,2013/11/23  vs. SJS,SJS,1,37,50,-13,-5,0,-8,-9,22,35,-13,-2,0,-11,-7
New Jersey Devils,2013/11/07  vs. PHI,PHI,1,30,34,-4,2,-6,0,-4,26,25,1,2,-1,0,-2
Anaheim Ducks,2014/01/17  vs. CHI,CHI,1,31,56,-25,-8,0,-17,-11,22,40,-18,-6,0,-12,-7
Nashville Predators,2014/03/27  vs. BUF,BUF,1,45,50,-5,1,-6,0,4,36,38,-2,1,-3,0,5
Detroit Red Wings,2014/03/07  vs. NJD,NJD,1,37,37,0,-2,0,2,-1,34,24,10,0,8,2,2
Edmonton Oilers,2013/12/03  vs. PHX,PHX,1,45,36,9,8,0,1,9,34,31,3,3,0,0,4
Edmonton Oilers,2013/11/15  vs. SJS,SJS,1,51,41,10,-1,0,11,1,36,34,2,-4,0,6,-3
Philadelphia Flyers,2014/03/20  vs. DAL,DAL,1,53,51,2,4,-2,0,6,33,35,-2,-1,-1,0,1
Colorado Avalanche,2013/12/16  vs. DAL,DAL,1,52,42,10,1,9,0,5,42,29,13,1,12,0,5
San Jose Sharks,2014/01/07  vs. NSH,NSH,1,42,42,0,-4,0,4,-4,30,36,-6,-5,0,-1,-7
Boston Bruins,2013/10/03  vs. TBL,TBL,1,47,38,9,-2,11,0,1,31,29,2,-5,7,0,-2
New Jersey Devils,2014/03/22  vs. NYR,NYR,1,40,28,12,1,0,11,3,29,24,5,-2,0,7,-1
New York Islanders,2013/12/31  vs. BOS,BOS,1,41,45,-4,-1,1,-4,-9,26,34,-8,-3,1,-6,-10
New Jersey Devils,2013/10/17  vs. OTT,OTT,1,37,24,13,2,0,11,2,32,20,12,1,0,11,2
Ottawa Senators,2014/03/15  vs. MTL,MTL,1,45,57,-12,-6,-5,-1,-6,35,41,-6,-7,2,-1,-7
Edmonton Oilers,2013/12/01  vs. DAL,DAL,1,39,49,-10,-4,0,-6,-2,27,35,-8,-3,0,-5,-2
Florida Panthers,2014/04/12  vs. CBJ,CBJ,1,31,38,-7,6,-2,-11,-1,27,30,-3,7,-2,-8,0
St. Louis Blues,2014/03/04  vs. TBL,TBL,1,46,30,16,7,-6,15,12,31,23,8,4,-4,8,6
Montreal Canadiens,2014/01/04  vs. OTT,OTT,1,38,47,-9,-4,0,-5,-6,31,34,-3,-4,0,1,-5
Colorado Avalanche,2014/01/11  vs. MIN,MIN,1,28,48,-20,-15,-5,0,-18,22,34,-12,-8,-4,0,-10
Washington Capitals,2013/12/29  vs. BUF,BUF,1,56,38,18,17,0,1,17,45,27,18,17,0,1,17
Dallas Stars,2013/10/03  vs. FLA,FLA,1,51,41,10,19,-5,-4,15,33,34,-1,9,-5,-5,5
Carolina Hurricanes,2014/01/18  vs. FLA,FLA,1,52,44,8,1,7,0,2,37,37,0,-5,5,0,-4
Detroit Red Wings,2013/10/10  vs. PHX,PHX,1,40,49,-9,-6,1,-4,-6,31,46,-15,-7,1,-9,-12
Chicago Blackhawks,2013/11/10  vs. EDM,EDM,1,56,25,31,19,8,4,21,38,22,16,11,7,-2,8
Philadelphia Flyers,2013/11/01  vs. WSH,WSH,1,37,41,-4,4,0,-8,0,26,32,-6,3,0,-9,-2
Florida Panthers,2013/12/19  vs. OTT,OTT,1,49,47,2,-3,-3,8,3,35,40,-5,-3,-2,0,-4
Minnesota Wild,2014/03/23  vs. DET,DET,1,43,30,13,9,-1,5,13,31,24,7,6,-1,2,11
Los Angeles Kings,2014/01/02  vs. STL,STL,1,49,29,20,-2,0,22,13,30,24,6,-1,0,7,9
San Jose Sharks,2014/03/24  vs. CGY,CGY,1,56,32,24,26,-2,0,24,42,25,17,18,-1,0,17
Pittsburgh Penguins,2013/11/06  vs. NYR,NYR,1,28,42,-14,-2,0,-12,-3,24,35,-11,-1,0,-10,-2
Detroit Red Wings,2014/01/26  vs. FLA,FLA,1,39,29,10,6,-1,5,16,28,28,0,4,-1,-3,6
Minnesota Wild,2013/11/05  vs. CGY,CGY,1,32,34,-2,0,-6,4,2,20,28,-8,-3,-7,2,-3
Vancouver Canucks,2013/10/20  vs. CBJ,CBJ,1,47,28,19,6,0,13,16,35,25,10,1,0,9,7
Edmonton Oilers,2013/11/09  vs. PHI,PHI,1,32,47,-15,6,0,-21,3,22,34,-12,3,0,-15,2
Washington Capitals,2013/11/05  vs. NYI,NYI,1,51,42,9,10,1,-2,9,38,31,7,9,1,-3,7
Pittsburgh Penguins,2014/03/06  vs. SJS,SJS,1,39,45,-6,3,-12,3,3,22,35,-13,0,-13,0,0
Winnipeg Jets,2014/04/10  vs. BOS,BOS,1,59,46,13,3,0,10,1,43,38,5,3,0,2,0
Detroit Red Wings,2014/03/16  vs. CHI,CHI,1,34,42,-8,-15,0,7,-15,27,27,0,-6,0,6,-6
Pittsburgh Penguins,2014/01/11  vs. CGY,CGY,1,35,34,1,4,-3,0,1,25,27,-2,3,-5,0,2
Minnesota Wild,2014/03/13  vs. NYR,NYR,1,33,39,-6,3,-9,0,8,26,27,-1,3,-4,0,8
Toronto Maple Leafs,2013/11/19  vs. NYI,NYI,1,47,57,-10,-1,-9,0,-9,33,41,-8,-1,-7,0,-6
Carolina Hurricanes,2013/10/10  vs. WSH,WSH,1,38,40,-2,1,6,-9,-8,32,33,-1,1,6,-8,-7
Pittsburgh Penguins,2014/01/23  vs. NYI,NYI,1,39,55,-16,0,-17,1,-1,35,39,-4,0,-8,4,2
Phoenix Coyotes,2013/10/03  vs. NYR,NYR,1,38,36,2,4,-2,0,0,25,22,3,5,-2,0,4
New Jersey Devils,2013/10/22  vs. CBJ,CBJ,1,42,30,12,12,3,-3,14,30,23,7,10,-1,-2,8
San Jose Sharks,2013/11/02  vs. PHX,PHX,1,52,36,16,4,-1,13,16,35,23,12,6,1,5,12
New Jersey Devils,2013/10/29  vs. TBL,TBL,1,28,23,5,8,-3,0,8,23,18,5,8,-3,0,7
Pittsburgh Penguins,2013/11/01  vs. CBJ,CBJ,1,43,45,-2,0,-2,0,3,32,35,-3,-1,-2,0,0
Nashville Predators,2013/12/17  vs. CHI,CHI,1,31,27,4,10,0,-6,12,17,22,-5,6,0,-11,4
New York Islanders,2013/11/27  vs. WPG,WPG,1,53,49,4,-9,0,13,-9,34,37,-3,-6,0,3,-7
Winnipeg Jets,2014/04/03  vs. PIT,PIT,1,28,37,-9,-1,-3,-5,-7,22,26,-4,0,2,-6,-1
New York Rangers,2014/01/16  vs. DET,DET,1,62,42,20,19,1,0,19,50,37,13,11,2,0,11
New Jersey Devils,2013/11/25  vs. WPG,WPG,1,39,24,15,0,0,15,6,28,19,9,0,0,9,5
Minnesota Wild,2014/03/22  vs. DET,DET,1,39,39,0,6,-4,-2,4,31,33,-2,6,-4,-4,3
Toronto Maple Leafs,2013/12/08  vs. BOS,BOS,1,56,57,-1,3,4,-8,-3,41,44,-3,0,4,-7,-2
St. Louis Blues,2014/02/01  vs. NSH,NSH,1,48,54,-6,-3,-2,-1,-6,35,42,-7,-2,-4,-1,-5
New York Rangers,2013/12/18  vs. PIT,PIT,1,39,36,3,-1,0,4,-1,26,28,-2,-4,0,2,-4
Pittsburgh Penguins,2013/10/15  vs. EDM,EDM,1,41,38,3,-1,4,0,5,29,23,6,-3,9,0,3
San Jose Sharks,2013/11/29  vs. STL,STL,1,40,36,4,0,4,0,2,26,21,5,0,5,0,2
Anaheim Ducks,2013/10/06  vs. WPG,WPG,1,48,34,14,12,0,2,14,38,22,16,10,0,6,16
Columbus Blue Jackets,2014/04/01  vs. COL,COL,1,45,42,3,8,-5,0,11,35,31,4,5,-1,0,8
Buffalo Sabres,2014/01/04  vs. NJD,NJD,1,19,36,-17,-11,-6,0,-10,12,20,-8,-6,-2,0,-5
Montreal Canadiens,2014/03/18  vs. COL,COL,1,50,45,5,8,-2,-1,7,38,33,5,6,-1,0,6
Boston Bruins,2013/11/23  vs. CAR,CAR,1,43,34,9,16,-4,-3,14,32,27,5,11,-3,-3,9
New York Rangers,2014/03/16  vs. SJS,SJS,1,62,47,15,12,0,3,9,46,30,16,12,0,4,11
Toronto Maple Leafs,2014/01/12  vs. NJD,NJD,1,34,60,-26,-29,3,0,-26,23,43,-20,-21,1,0,-20
Toronto Maple Leafs,2014/02/01  vs. OTT,OTT,1,43,50,-7,-13,-3,9,-4,34,36,-2,-10,0,8,-2
Washington Capitals,2014/01/14  vs. SJS,SJS,1,61,52,9,-1,0,10,9,41,36,5,-2,0,7,5
Tampa Bay Lightning,2013/12/23  vs. FLA,FLA,1,52,31,21,1,20,0,3,42,27,15,2,13,0,3
New York Islanders,2013/11/01  vs. OTT,OTT,1,68,42,26,12,0,14,16,57,25,32,17,0,15,21
Columbus Blue Jackets,2014/03/04  vs. DAL,DAL,1,28,38,-10,0,-10,0,4,20,27,-7,0,-7,0,5
New Jersey Devils,2013/12/14  vs. TBL,TBL,1,34,42,-8,-5,-3,0,-8,25,38,-13,-9,-4,0,-12
Minnesota Wild,2013/12/27  vs. WPG,WPG,1,41,54,-13,-11,1,-3,-12,30,36,-6,-7,5,-4,-4
Washington Capitals,2013/10/28  vs. VAN,VAN,1,28,44,-16,-20,1,3,-19,19,35,-16,-16,1,-1,-16
Washington Capitals,2014/04/08  vs. STL,STL,1,20,53,-33,-10,-23,0,-15,14,35,-21,-6,-15,0,-9
Nashville Predators,2013/10/10  vs. TOR,TOR,1,43,34,9,1,0,8,0,33,26,7,3,0,4,3
Buffalo Sabres,2014/01/09  vs. FLA,FLA,1,35,49,-14,-8,-6,0,-10,26,37,-11,-5,-6,0,-7
Carolina Hurricanes,2013/11/02  vs. NYR,NYR,1,43,47,-4,11,0,-15,5,34,35,-1,11,0,-12,3
Washington Capitals,2013/10/10  vs. CAR,CAR,1,40,38,2,-1,9,-6,8,33,32,1,-1,8,-6,7
Vancouver Canucks,2013/12/14  vs. BOS,BOS,1,40,69,-29,-2,-27,0,-6,28,52,-24,-7,-17,0,-9
Toronto Maple Leafs,2013/10/12  vs. EDM,EDM,1,46,40,6,8,0,-2,2,28,29,-1,4,0,-5,-3
Edmonton Oilers,2014/04/08  vs. COL,COL,1,42,54,-12,-1,0,-11,-5,27,43,-16,-2,0,-14,-7
Toronto Maple Leafs,2013/12/21  vs. DET,DET,1,30,67,-37,-25,-4,-8,-33,24,55,-31,-23,-3,-5,-27
New York Rangers,2014/01/03  vs. PIT,PIT,1,47,37,10,2,0,8,4,35,31,4,2,0,2,2
New York Islanders,2014/01/10  vs. COL,COL,1,28,47,-19,-22,0,3,-22,21,33,-12,-14,0,2,-14
Edmonton Oilers,2014/01/21  vs. VAN,VAN,1,39,46,-7,3,0,-10,-15,28,34,-6,1,0,-7,-11
Montreal Canadiens,2014/03/22  vs. TOR,TOR,1,55,59,-4,-3,-1,0,-5,45,40,5,1,4,0,4
Los Angeles Kings,2014/02/27  vs. CGY,CGY,1,29,35,-6,0,-6,0,-9,22,24,-2,1,-3,0,-6
Washington Capitals,2013/11/27  vs. OTT,OTT,1,40,41,-1,2,0,-3,3,32,34,-2,-2,1,-1,-1
Boston Bruins,2014/02/01  vs. EDM,EDM,1,54,32,22,13,9,0,11,43,29,14,7,7,0,5
New York Rangers,2013/11/21  vs. DAL,DAL,1,49,66,-17,2,-19,0,-10,41,49,-8,2,-10,0,-5
St. Louis Blues,2013/11/23  vs. DAL,DAL,1,38,52,-14,-2,-12,0,-6,31,40,-9,-1,-8,0,-4
Columbus Blue Jackets,2013/11/20  vs. CGY,CGY,1,39,43,-4,5,-9,0,4,19,32,-13,-2,-11,0,-7
Pittsburgh Penguins,2014/01/05  vs. WPG,WPG,1,46,49,-3,-13,-1,11,-9,38,39,-1,-9,-1,9,-6
Ottawa Senators,2013/12/18  vs. NJD,NJD,1,32,31,1,-1,0,2,-2,27,27,0,0,0,0,-2
Buffalo Sabres,2014/01/30  vs. PHX,PHX,1,41,54,-13,-5,-16,8,-3,30,39,-9,-6,-9,6,-4
New York Rangers,2013/11/12  vs. NJD,NJD,1,47,39,8,0,0,8,-2,35,25,10,6,0,4,4
Buffalo Sabres,2014/04/13  vs. NYI,NYI,1,50,43,7,6,1,0,7,44,29,15,8,7,0,12
Detroit Red Wings,2013/11/09  vs. TBL,TBL,1,35,47,-12,-9,-1,-2,-9,23,39,-16,-7,-3,-6,-11
Boston Bruins,2013/12/14  vs. VAN,VAN,1,69,40,29,2,0,27,6,52,28,24,7,0,17,9
Los Angeles Kings,2013/11/02  vs. NSH,NSH,1,68,31,37,6,0,31,12,48,23,25,0,0,25,5
Anaheim Ducks,2013/12/28  vs. PHX,PHX,1,45,45,0,6,-6,0,3,37,32,5,6,-1,0,4
Ottawa Senators,2013/10/25  vs. ANA,ANA,1,36,39,-3,2,0,-5,6,26,31,-5,3,0,-8,4
Montreal Canadiens,2014/01/28  vs. CAR,CAR,1,37,57,-20,-5,-15,0,-3,28,36,-8,-4,-4,0,-2
Vancouver Canucks,2014/03/10  vs. NYI,NYI,1,34,34,0,2,-1,-1,-1,24,29,-5,-1,0,-4,-3
Carolina Hurricanes,2013/10/04  vs. DET,DET,1,43,53,-10,-5,-5,0,-7,32,38,-6,-5,-1,0,-6
Winnipeg Jets,2014/01/16  vs. CGY,CGY,1,38,38,0,0,0,0,2,25,29,-4,0,-4,0,3
Detroit Red Wings,2014/04/05  vs. MTL,MTL,1,40,34,6,-2,0,8,-2,26,26,0,-3,0,3,-3
Nashville Predators,2014/03/01  vs. WPG,WPG,1,50,31,19,6,0,13,13,37,18,19,7,0,12,12
New York Islanders,2013/12/03  vs. PIT,PIT,1,40,54,-14,-5,-9,0,-1,31,44,-13,-3,-10,0,-2
Minnesota Wild,2013/11/03  vs. NJD,NJD,1,26,42,-16,-5,-11,0,-1,19,25,-6,-4,-2,0,-1
Montreal Canadiens,2013/12/10  vs. LAK,LAK,1,44,52,-8,-6,0,-2,-1,31,35,-4,-5,0,1,0
Phoenix Coyotes,2014/04/12  vs. SJS,SJS,1,60,41,19,-2,0,21,3,43,31,12,-1,0,13,0
Vancouver Canucks,2014/03/23  vs. BUF,BUF,1,73,35,38,6,16,16,34,54,22,32,6,14,12,28
Calgary Flames,2013/11/12  vs. SJS,SJS,1,27,68,-41,-6,0,-35,-27,15,46,-31,-3,0,-28,-18
Anaheim Ducks,2014/02/05  vs. CHI,CHI,1,43,36,7,6,0,1,5,27,29,-2,2,0,-4,-1
Buffalo Sabres,2014/04/04  vs. DET,DET,1,38,57,-19,-3,0,-16,1,25,37,-12,-3,0,-9,-1
St. Louis Blues,2013/12/23  vs. CGY,CGY,1,44,32,12,3,9,0,9,36,21,15,3,12,0,8
Calgary Flames,2014/03/03  vs. MIN,MIN,1,40,38,2,2,0,0,3,28,30,-2,-2,0,0,0
Pittsburgh Penguins,2013/11/29  vs. TBL,TBL,1,43,41,2,-3,5,0,1,32,28,4,0,4,0,5
Anaheim Ducks,2014/01/23  vs. LAK,LAK,1,25,41,-16,1,-4,-13,-12,21,32,-11,1,1,-13,-11
St. Louis Blues,2014/02/04  vs. OTT,OTT,1,48,41,7,6,1,0,7,38,32,6,6,0,0,3
San Jose Sharks,2014/01/14  vs. WSH,WSH,1,52,61,-9,1,-10,0,-9,36,41,-5,2,-7,0,-5
New York Rangers,2014/04/12  vs. MTL,MTL,1,44,40,4,4,0,0,4,38,26,12,12,0,0,12
New Jersey Devils,2014/01/31  vs. NSH,NSH,1,37,34,3,-6,7,2,-4,26,31,-5,-7,3,-1,-8
Boston Bruins,2014/01/02  vs. NSH,NSH,1,54,45,9,4,0,5,3,33,36,-3,-6,0,3,-7
Colorado Avalanche,2014/04/06  vs. PIT,PIT,1,44,45,-1,2,0,-3,1,33,37,-4,1,0,-5,0
Calgary Flames,2014/04/01  vs. TOR,TOR,1,54,50,4,4,0,0,3,44,35,9,4,0,5,7
New York Islanders,2013/10/26  vs. PHI,PHI,1,47,57,-10,3,0,-13,-6,31,44,-13,1,0,-14,-6
Vancouver Canucks,2014/02/04  vs. BOS,BOS,1,53,53,0,4,0,-4,17,39,44,-5,2,0,-7,10
Anaheim Ducks,2014/03/14  vs. COL,COL,1,49,36,13,12,4,-3,7,36,29,7,10,2,-5,3
Florida Panthers,2013/11/15  vs. MIN,MIN,1,40,26,14,-3,0,17,-3,30,19,11,-1,0,12,0
San Jose Sharks,2014/03/18  vs. FLA,FLA,1,65,37,28,2,6,20,7,49,28,21,-2,6,17,2
Washington Capitals,2013/11/02  vs. FLA,FLA,1,34,45,-11,-11,0,0,-10,27,27,0,-4,4,0,2
Anaheim Ducks,2014/01/12  vs. DET,DET,1,29,41,-12,-1,-11,0,-2,21,27,-6,-2,-4,0,-1
Montreal Canadiens,2014/01/22  vs. PIT,PIT,1,40,38,2,-2,0,4,2,29,30,-1,-1,0,0,2
Tampa Bay Lightning,2014/01/09  vs. WSH,WSH,1,49,47,2,-1,2,1,-4,38,32,6,0,3,3,0
Boston Bruins,2014/03/24  vs. MTL,MTL,1,38,20,18,-2,0,20,19,28,13,15,1,0,14,17
Calgary Flames,2013/11/03  vs. CHI,CHI,1,39,72,-33,-27,-4,-2,-29,32,48,-16,-14,-1,-1,-15
St. Louis Blues,2014/01/07  vs. EDM,EDM,1,48,33,15,8,7,0,8,35,25,10,6,4,0,5
San Jose Sharks,2013/11/30  vs. ANA,ANA,1,44,49,-5,3,-6,-2,-1,27,36,-9,1,-8,-2,-3
Boston Bruins,2013/12/23  vs. NSH,NSH,1,46,58,-12,-1,-11,0,0,40,40,0,-1,1,0,1
Montreal Canadiens,2014/03/25  vs. BUF,BUF,1,45,29,16,14,2,0,14,34,19,15,14,1,0,14
Minnesota Wild,2014/03/08  vs. DAL,DAL,1,48,49,-1,2,-3,0,0,39,37,2,1,-3,4,3
Pittsburgh Penguins,2014/01/22  vs. MTL,MTL,1,38,40,-2,2,-4,0,-2,30,29,1,1,0,0,-2
Los Angeles Kings,2014/03/29  vs. WPG,WPG,1,50,45,5,3,2,0,4,39,37,2,3,-1,0,5
Dallas Stars,2014/01/21  vs. MIN,MIN,1,43,34,9,15,-6,0,12,31,24,7,10,-3,0,8
New York Rangers,2013/10/03  vs. PHX,PHX,1,36,38,-2,-4,0,2,0,22,25,-3,-5,0,2,-4
Boston Bruins,2013/11/18  vs. CAR,CAR,1,58,40,18,0,18,0,8,39,32,7,0,7,0,2
Tampa Bay Lightning,2014/03/06  vs. BUF,BUF,1,76,35,41,8,0,33,21,56,30,26,8,0,18,11
Ottawa Senators,2013/11/28  vs. VAN,VAN,1,58,36,22,3,3,16,5,41,27,14,-1,3,12,1
New York Islanders,2014/03/27  vs. TBL,TBL,1,40,44,-4,0,-1,-3,-2,29,32,-3,-2,0,-1,-1
Vancouver Canucks,2013/12/06  vs. PHX,PHX,1,42,56,-14,1,-15,0,1,34,40,-6,2,-8,0,4
Columbus Blue Jackets,2014/03/23  vs. NYI,NYI,1,40,33,7,-2,0,9,5,32,32,0,-3,0,3,-2
Carolina Hurricanes,2014/01/02  vs. WSH,WSH,1,44,63,-19,-15,-2,-2,-19,35,47,-12,-10,0,-2,-12
Florida Panthers,2013/12/03  vs. OTT,OTT,1,42,49,-7,-5,-4,2,-10,33,39,-6,-4,-3,1,-8
Dallas Stars,2013/12/27  vs. NSH,NSH,1,53,55,-2,-1,-1,0,7,40,43,-3,-1,-2,0,5
Nashville Predators,2014/01/26  vs. EDM,EDM,1,55,45,10,-3,0,13,-9,39,34,5,-4,0,9,-4
Los Angeles Kings,2014/01/25  vs. ANA,ANA,1,45,27,18,3,0,15,5,32,26,6,2,0,4,3
Detroit Red Wings,2013/10/04  vs. CAR,CAR,1,53,43,10,5,0,5,7,38,32,6,5,0,1,6
Tampa Bay Lightning,2013/12/03  vs. CBJ,CBJ,1,37,38,-1,4,0,-5,-6,29,28,1,4,0,-3,-4
Colorado Avalanche,2013/12/08  vs. VAN,VAN,1,48,42,6,1,0,5,-2,35,27,8,2,0,6,3
Winnipeg Jets,2013/11/15  vs. PHI,PHI,1,49,31,18,13,-1,6,12,39,24,15,10,-1,6,11
Montreal Canadiens,2013/10/24  vs. ANA,ANA,1,33,50,-17,7,-24,0,4,24,37,-13,3,-16,0,1
Edmonton Oilers,2013/11/05  vs. FLA,FLA,1,33,40,-7,-7,-1,1,-6,23,28,-5,-1,-4,0,0
Chicago Blackhawks,2014/01/29  vs. VAN,VAN,1,64,58,6,1,4,1,1,52,32,20,2,12,6,6
Tampa Bay Lightning,2013/11/16  vs. PHX,PHX,1,44,36,8,2,0,6,1,36,27,9,2,0,7,1
Boston Bruins,2014/01/20  vs. LAK,LAK,1,36,37,-1,3,-4,0,8,27,25,2,1,1,0,8
Philadelphia Flyers,2014/03/15  vs. PIT,PIT,1,53,34,19,3,16,0,5,39,24,15,2,13,0,3
Pittsburgh Penguins,2014/03/20  vs. DET,DET,1,34,32,2,3,0,-1,5,27,23,4,6,0,-2,8
Detroit Red Wings,2013/11/21  vs. CAR,CAR,1,54,35,19,0,19,0,15,46,29,17,0,17,0,14
New York Islanders,2014/03/23  vs. CBJ,CBJ,1,33,40,-7,2,-9,0,-5,32,32,0,3,-3,0,2
Carolina Hurricanes,2014/03/07  vs. NYR,NYR,1,36,53,-17,-10,-8,1,-17,27,40,-13,-10,-4,1,-13
Detroit Red Wings,2014/02/03  vs. VAN,VAN,1,37,22,15,6,9,0,6,31,20,11,4,7,0,4
Florida Panthers,2014/03/18  vs. SJS,SJS,1,37,65,-28,-2,-20,-6,-7,28,49,-21,2,-17,-6,-2
San Jose Sharks,2013/10/24  vs. BOS,BOS,1,66,37,29,32,0,-3,29,49,26,23,25,0,-2,23
Ottawa Senators,2013/10/27  vs. SJS,SJS,1,52,38,14,-2,0,16,9,39,31,8,-1,0,9,4
San Jose Sharks,2014/03/13  vs. CBJ,CBJ,1,37,55,-18,6,-8,-16,-11,27,40,-13,5,-5,-13,-9
Washington Capitals,2013/11/10  vs. COL,COL,1,43,51,-8,1,0,-9,-10,32,35,-3,1,0,-4,-6
Edmonton Oilers,2013/11/13  vs. DAL,DAL,1,25,41,-16,-7,0,-9,-15,19,29,-10,-4,0,-6,-10
Detroit Red Wings,2013/11/24  vs. BUF,BUF,1,47,39,8,-3,2,9,6,31,29,2,-7,2,7,0
Philadelphia Flyers,2014/04/13  vs. CAR,CAR,1,53,43,10,1,0,9,1,41,32,9,4,0,5,1
Carolina Hurricanes,2014/01/09  vs. TOR,TOR,1,44,58,-14,-1,-13,0,0,36,39,-3,0,-3,0,1
Washington Capitals,2014/03/02  vs. PHI,PHI,1,33,42,-9,-3,-6,0,-3,24,29,-5,0,-5,0,-2
Winnipeg Jets,2013/12/23  vs. EDM,EDM,1,40,38,2,-3,0,5,-1,32,32,0,-4,0,4,-3
Chicago Blackhawks,2014/03/12  vs. COL,COL,1,45,42,3,-2,0,5,-2,34,28,6,2,0,4,3
Tampa Bay Lightning,2014/03/24  vs. OTT,OTT,1,38,51,-13,-11,0,-2,-11,33,35,-2,-2,0,0,0
Montreal Canadiens,2013/11/15  vs. CBJ,CBJ,1,47,34,13,18,0,-5,14,34,26,8,13,0,-5,9
Edmonton Oilers,2014/01/05  vs. TBL,TBL,1,34,53,-19,-6,-13,0,-10,27,42,-15,-7,-8,0,-8
Florida Panthers,2014/01/28  vs. BOS,BOS,1,46,53,-7,-7,0,0,-11,38,44,-6,-4,0,-2,-8
Colorado Avalanche,2014/04/01  vs. CBJ,CBJ,1,42,45,-3,-8,0,5,-11,31,35,-4,-5,0,1,-8
Calgary Flames,2014/04/03  vs. TBL,TBL,1,35,57,-22,-4,-18,0,-5,27,37,-10,-2,-8,0,-2
Colorado Avalanche,2014/01/27  vs. DAL,DAL,1,37,51,-14,-6,-8,0,-8,25,37,-12,-5,-7,0,-5
New Jersey Devils,2014/04/05  vs. CAR,CAR,1,51,42,9,7,2,0,3,38,28,10,0,10,0,3
Detroit Red Wings,2013/12/21  vs. TOR,TOR,1,67,30,37,25,8,4,33,55,24,31,23,5,3,27
Florida Panthers,2013/11/09  vs. OTT,OTT,1,48,40,8,1,0,7,9,39,31,8,1,0,7,6
Minnesota Wild,2013/10/12  vs. DAL,DAL,1,50,32,18,0,18,0,6,37,22,15,0,15,0,4
Toronto Maple Leafs,2013/12/19  vs. PHX,PHX,1,37,63,-26,-3,-23,0,-14,27,43,-16,-3,-13,0,-10
Florida Panthers,2014/04/06  vs. DAL,DAL,1,42,37,5,-4,2,7,-3,30,31,-1,-5,2,2,-5
Philadelphia Flyers,2013/12/21  vs. CBJ,CBJ,1,26,33,-7,-3,0,-4,-7,21,27,-6,-1,0,-5,-3
New York Rangers,2013/11/17  vs. LAK,LAK,1,38,56,-18,-4,0,-14,-18,30,39,-9,4,0,-13,-8
Anaheim Ducks,2013/12/09  vs. NYI,NYI,1,49,55,-6,-11,4,1,-10,33,39,-6,-10,-1,5,-5
Los Angeles Kings,2013/11/14  vs. NYI,NYI,1,39,32,7,8,1,-2,6,25,25,0,1,1,-2,-1
Calgary Flames,2013/12/07  vs. EDM,EDM,1,26,46,-20,-12,-8,0,-15,21,27,-6,-7,1,0,-8
San Jose Sharks,2014/01/23  vs. WPG,WPG,1,60,35,25,22,3,0,22,46,25,21,17,4,0,17
Detroit Red Wings,2013/12/07  vs. FLA,FLA,1,33,51,-18,-9,-10,1,-19,27,42,-15,-8,-7,0,-15
Phoenix Coyotes,2014/03/04  vs. VAN,VAN,1,48,53,-5,-3,-2,0,4,36,33,3,-1,4,0,9
New York Islanders,2013/10/25  vs. PIT,PIT,1,57,45,12,8,3,1,8,34,36,-2,5,1,-8,-3
Tampa Bay Lightning,2014/02/01  vs. MTL,MTL,1,48,36,12,7,5,0,10,35,26,9,5,4,0,6
Toronto Maple Leafs,2013/11/15  vs. BUF,BUF,1,47,24,23,7,0,16,14,37,21,16,3,1,12,10
Ottawa Senators,2013/12/07  vs. TOR,TOR,1,52,35,17,3,0,14,4,45,31,14,1,0,13,2
Boston Bruins,2013/11/07  vs. FLA,FLA,1,51,39,12,2,10,0,4,39,24,15,8,7,0,5
New Jersey Devils,2013/11/20  vs. ANA,ANA,1,40,28,12,4,-1,9,3,29,19,10,2,1,7,3
St. Louis Blues,2013/10/25  vs. VAN,VAN,1,47,29,18,12,0,6,12,35,22,13,10,0,3,9
Edmonton Oilers,2014/04/02  vs. ANA,ANA,1,35,35,0,2,-1,-1,2,33,24,9,8,2,-1,9
Detroit Red Wings,2013/12/06  vs. NJD,NJD,1,24,19,5,1,1,3,4,22,14,8,2,1,5,7
Montreal Canadiens,2014/03/12  vs. BOS,BOS,1,55,43,12,4,0,8,2,41,32,9,5,0,4,4
Anaheim Ducks,2014/03/26  vs. CGY,CGY,1,54,59,-5,-8,2,1,-3,37,44,-7,-9,2,0,-7
Dallas Stars,2014/01/16  vs. BOS,BOS,1,37,53,-16,-8,0,-8,-9,26,40,-14,-7,0,-7,-8
Columbus Blue Jackets,2014/03/08  vs. NSH,NSH,1,41,44,-3,-9,6,0,-9,34,29,5,-1,6,0,-1
Washington Capitals,2014/01/24  vs. NJD,NJD,1,31,27,4,4,0,0,1,25,25,0,4,0,-4,0
Phoenix Coyotes,2013/10/10  vs. DET,DET,1,49,40,9,6,4,-1,6,46,31,15,7,9,-1,12
Florida Panthers,2014/03/02  vs. NYI,NYI,1,44,34,10,-1,5,6,-2,34,26,8,-1,5,4,-2
New York Islanders,2013/11/22  vs. PIT,PIT,1,46,47,-1,-2,0,1,1,36,36,0,-2,0,2,1
Montreal Canadiens,2014/02/08  vs. CAR,CAR,1,40,62,-22,-2,-15,-5,-5,31,46,-15,-3,-8,-4,-5
Vancouver Canucks,2014/03/02  vs. OTT,OTT,1,33,36,-3,-1,-5,3,-12,28,30,-2,2,-4,0,-8
Buffalo Sabres,2014/02/03  vs. EDM,EDM,1,53,31,22,1,8,13,16,43,26,17,1,6,10,10
Columbus Blue Jackets,2014/03/15  vs. MIN,MIN,1,47,49,-2,-1,-1,0,-1,39,40,-1,0,-1,0,0
Toronto Maple Leafs,2014/03/03  vs. CBJ,CBJ,1,47,60,-13,-5,0,-8,-3,36,43,-7,-1,0,-6,0
Minnesota Wild,2013/10/19  vs. FLA,FLA,1,32,25,7,2,5,0,4,23,22,1,0,1,0,1
Columbus Blue Jackets,2014/02/01  vs. FLA,FLA,1,43,53,-10,6,-16,0,10,33,39,-6,5,-11,0,9
St. Louis Blues,2014/04/11  vs. DAL,DAL,1,33,56,-23,-1,0,-22,-4,26,44,-18,0,0,-18,-5
Buffalo Sabres,2013/11/24  vs. DET,DET,1,39,47,-8,3,-9,-2,-6,29,31,-2,7,-7,-2,0
Nashville Predators,2014/01/02  vs. BOS,BOS,1,45,54,-9,-4,-5,0,-3,36,33,3,6,-3,0,7
Anaheim Ducks,2013/11/26  vs. DAL,DAL,1,52,47,5,0,-2,7,2,40,39,1,0,2,-1,4
San Jose Sharks,2013/10/10  vs. VAN,VAN,1,48,30,18,4,14,0,10,35,19,16,3,13,0,8
Anaheim Ducks,2014/04/13  vs. COL,COL,1,57,52,5,-15,0,20,2,52,38,14,-6,0,20,11
Tampa Bay Lightning,2014/03/30  vs. DET,DET,1,33,38,-5,-6,1,0,-7,27,31,-4,-4,2,-2,-4
Calgary Flames,2014/02/08  vs. PHI,PHI,1,60,37,23,4,0,19,16,45,27,18,6,0,12,12
Detroit Red Wings,2014/01/20  vs. STL,STL,1,36,36,0,-5,0,5,-4,26,28,-2,-4,0,2,-2
Detroit Red Wings,2014/03/18  vs. TOR,TOR,1,43,46,-3,1,-4,0,2,34,34,0,1,-1,0,1
Dallas Stars,2014/03/06  vs. VAN,VAN,1,36,41,-5,4,-9,0,9,25,30,-5,1,-6,0,5
Colorado Avalanche,2013/11/19  vs. CHI,CHI,1,34,60,-26,0,-26,0,0,26,45,-19,0,-19,0,-1
Minnesota Wild,2013/10/26  vs. CHI,CHI,1,24,47,-23,-3,-20,0,-8,19,35,-16,-2,-14,0,-5
Columbus Blue Jackets,2014/03/18  vs. CAR,CAR,1,62,19,43,1,0,42,16,48,14,34,1,0,33,12
Chicago Blackhawks,2013/10/05  vs. TBL,TBL,1,48,34,14,8,6,0,14,39,17,22,13,9,0,17
Phoenix Coyotes,2014/01/26  vs. VAN,VAN,1,35,46,-11,-14,0,3,-11,26,29,-3,0,0,-3,0
Columbus Blue Jackets,2013/12/12  vs. NYR,NYR,1,40,53,-13,1,-14,0,5,32,39,-7,1,-8,0,4
New York Rangers,2014/01/23  vs. STL,STL,1,47,45,2,9,0,-7,5,36,30,6,4,0,2,7
Vancouver Canucks,2014/03/19  vs. NSH,NSH,1,41,40,1,4,-3,0,4,31,32,-1,1,-2,0,1
Buffalo Sabres,2014/04/08  vs. DET,DET,1,31,45,-14,-10,0,-4,-10,23,32,-9,-6,0,-3,-6
New York Rangers,2014/01/19  vs. WSH,WSH,1,35,47,-12,0,-12,0,0,26,32,-6,0,-6,0,-1
Buffalo Sabres,2013/11/08  vs. ANA,ANA,1,49,66,-17,-3,0,-14,-6,36,60,-24,-3,0,-21,-7
Los Angeles Kings,2014/01/23  vs. ANA,ANA,1,41,25,16,-1,13,4,12,32,21,11,-1,13,-1,11
Edmonton Oilers,2014/03/28  vs. ANA,ANA,1,29,62,-33,-15,-14,-4,-25,22,49,-27,-13,-10,-4,-22
New York Rangers,2013/11/02  vs. CAR,CAR,1,47,43,4,-11,15,0,-5,35,34,1,-11,12,0,-3
Winnipeg Jets,2014/03/08  vs. OTT,OTT,1,45,36,9,-5,0,14,-2,39,30,9,-5,0,14,-1
Toronto Maple Leafs,2013/11/23  vs. WSH,WSH,1,46,82,-36,-23,-13,0,-21,33,56,-23,-15,-8,0,-14
Boston Bruins,2014/04/12  vs. BUF,BUF,1,45,27,18,7,11,0,8,32,22,10,2,8,0,4
New York Islanders,2013/11/19  vs. TOR,TOR,1,57,47,10,1,0,9,9,41,33,8,1,0,7,6
New York Islanders,2013/10/22  vs. VAN,VAN,1,52,58,-6,4,-5,-5,-2,37,41,-4,2,-4,-2,-3
Chicago Blackhawks,2014/03/04  vs. COL,COL,1,51,27,24,13,0,11,18,36,17,19,10,0,9,14
Montreal Canadiens,2014/03/15  vs. OTT,OTT,1,57,45,12,6,1,5,6,41,35,6,7,1,-2,7
Edmonton Oilers,2014/03/18  vs. NSH,NSH,1,42,44,-2,4,-6,0,-1,31,32,-1,4,-5,0,-1
Columbus Blue Jackets,2014/04/08  vs. PHX,PHX,1,50,46,4,5,1,-2,1,33,33,0,5,-1,-4,-1
Toronto Maple Leafs,2013/11/30  vs. MTL,MTL,1,48,47,1,0,0,1,2,34,37,-3,0,0,-3,2
Florida Panthers,2014/03/14  vs. NJD,NJD,1,30,55,-25,-8,2,-19,-17,26,37,-11,-3,4,-12,-7
Los Angeles Kings,2014/01/20  vs. BOS,BOS,1,37,36,1,-3,0,4,-8,25,27,-2,-1,0,-1,-8
Columbus Blue Jackets,2014/03/29  vs. CAR,CAR,1,47,49,-2,1,0,-3,-2,35,33,2,5,0,-3,2
Columbus Blue Jackets,2013/11/27  vs. NSH,NSH,1,36,35,1,-5,0,6,-6,25,26,-1,-4,0,3,-5
San Jose Sharks,2013/10/08  vs. NYR,NYR,1,82,46,36,12,24,0,29,62,33,29,9,20,0,23
Dallas Stars,2014/03/20  vs. PHI,PHI,1,51,53,-2,-4,0,2,-6,35,33,2,1,0,1,-1
Calgary Flames,2014/04/04  vs. FLA,FLA,1,25,50,-25,-17,-8,0,-21,17,34,-17,-11,-6,0,-15
Los Angeles Kings,2013/10/03  vs. MIN,MIN,1,35,30,5,-5,0,10,-3,18,21,-3,-2,0,-1,-8
Montreal Canadiens,2013/11/02  vs. COL,COL,1,44,48,-4,-6,0,2,-6,32,40,-8,-9,0,1,-10
Nashville Predators,2014/01/12  vs. MIN,MIN,1,55,36,19,2,0,17,-1,35,31,4,0,0,4,-3
Edmonton Oilers,2013/11/16  vs. CGY,CGY,1,33,51,-18,-10,6,-14,-14,26,39,-13,-9,6,-10,-12
Boston Bruins,2014/04/10  vs. WPG,WPG,1,46,59,-13,-3,-10,0,-1,38,43,-5,-3,-2,0,0
San Jose Sharks,2013/11/10  vs. WPG,WPG,1,36,50,-14,-5,-9,0,-13,30,41,-11,-2,-9,0,-11
Tampa Bay Lightning,2013/10/26  vs. BUF,BUF,1,42,22,20,21,0,-1,20,33,17,16,15,2,-1,14
Philadelphia Flyers,2013/12/07  vs. DAL,DAL,1,45,36,9,6,3,0,7,26,30,-4,0,1,-5,-1
Minnesota Wild,2013/12/12  vs. SJS,SJS,1,45,32,13,-1,0,14,-5,33,28,5,0,0,5,-3
Vancouver Canucks,2013/12/09  vs. CAR,CAR,1,40,48,-8,-3,-5,0,-2,29,37,-8,-3,-5,0,-3
St. Louis Blues,2013/11/21  vs. BOS,BOS,1,43,59,-16,-16,1,-1,-16,28,38,-10,-10,1,-1,-10
Colorado Avalanche,2014/01/21  vs. TOR,TOR,1,54,38,16,5,0,11,10,42,29,13,3,0,10,4
Colorado Avalanche,2013/12/31  vs. CBJ,CBJ,1,34,50,-16,1,-9,-8,-15,22,41,-19,-5,-7,-7,-17
Boston Bruins,2013/12/28  vs. OTT,OTT,1,41,51,-10,3,0,-13,-5,36,35,1,7,0,-6,2
Winnipeg Jets,2014/02/08  vs. STL,STL,1,35,21,14,9,0,5,9,26,15,11,8,0,3,9
Carolina Hurricanes,2013/10/28  vs. PIT,PIT,1,34,46,-12,-10,0,-2,-11,24,38,-14,-9,0,-5,-11
Montreal Canadiens,2013/11/07  vs. OTT,OTT,1,42,33,9,5,0,4,4,28,22,6,3,0,3,2
Tampa Bay Lightning,2013/11/07  vs. EDM,EDM,1,43,46,-3,10,-13,0,4,31,38,-7,4,-11,0,-3
Chicago Blackhawks,2013/10/22  vs. FLA,FLA,1,59,49,10,15,-5,0,4,34,37,-3,5,-8,0,-2
New Jersey Devils,2013/10/13  vs. WPG,WPG,1,44,37,7,4,0,3,8,29,31,-2,2,0,-4,1
New York Rangers,2013/12/12  vs. CBJ,CBJ,1,53,40,13,-1,0,14,-5,39,32,7,-1,0,8,-4
Los Angeles Kings,2013/12/31  vs. DAL,DAL,1,42,38,4,3,4,-3,4,29,28,1,0,4,-3,0
St. Louis Blues,2013/10/15  vs. SJS,SJS,1,44,42,2,-6,0,8,-6,30,38,-8,-6,0,-2,-6
Philadelphia Flyers,2014/01/20  vs. NYI,NYI,1,28,51,-23,0,-23,0,-5,20,36,-16,-5,-11,0,-5
Vancouver Canucks,2013/11/22  vs. CBJ,CBJ,1,45,28,17,3,2,12,16,33,16,17,3,9,5,9
Philadelphia Flyers,2013/10/08  vs. FLA,FLA,1,37,49,-12,-3,-9,0,-3,27,37,-10,-4,-6,0,-3
Minnesota Wild,2014/03/03  vs. CGY,CGY,1,38,40,-2,-2,0,0,-3,30,28,2,2,0,0,0
Anaheim Ducks,2014/03/02  vs. CAR,CAR,1,48,61,-13,4,-17,0,5,34,52,-18,2,-20,0,1
Columbus Blue Jackets,2014/03/20  vs. MTL,MTL,1,45,37,8,4,3,1,5,37,26,11,7,3,1,10
Florida Panthers,2014/01/06  vs. MTL,MTL,1,62,46,16,11,0,5,-1,38,37,1,0,0,1,-9
Tampa Bay Lightning,2013/10/24  vs. CHI,CHI,1,24,51,-27,-8,-20,1,-27,21,40,-19,-9,-14,4,-22
San Jose Sharks,2013/11/05  vs. BUF,BUF,1,61,45,16,6,-1,11,5,42,36,6,2,0,4,0
Vancouver Canucks,2014/03/29  vs. ANA,ANA,1,48,33,15,0,0,15,-2,36,25,11,-1,0,12,0
Pittsburgh Penguins,2013/12/03  vs. NYI,NYI,1,54,40,14,5,0,9,1,44,31,13,3,0,10,2
Columbus Blue Jackets,2014/01/02  vs. PHX,PHX,1,42,42,0,21,-21,0,20,34,32,2,18,-16,0,17
Buffalo Sabres,2013/12/23  vs. PHX,PHX,1,37,39,-2,-5,0,3,0,29,29,0,-5,0,5,2
Buffalo Sabres,2013/10/19  vs. COL,COL,1,40,35,5,-11,0,16,-14,31,28,3,-8,0,11,-11
New Jersey Devils,2013/11/29  vs. CAR,CAR,1,48,28,20,11,7,2,12,35,18,17,11,8,-2,12
Edmonton Oilers,2014/01/02  vs. SJS,SJS,1,34,55,-21,-9,0,-12,-11,26,44,-18,-7,0,-11,-9
Winnipeg Jets,2014/04/11  vs. CGY,CGY,1,50,57,-7,7,-14,0,-1,34,39,-5,1,-6,0,-3
Philadelphia Flyers,2014/03/18  vs. CHI,CHI,1,49,33,16,11,0,5,14,37,25,12,7,0,5,10
Minnesota Wild,2014/04/13  vs. NSH,NSH,1,44,36,8,-5,2,11,-2,33,31,2,-5,2,5,-1
Minnesota Wild,2013/11/23  vs. WPG,WPG,1,55,60,-5,-6,0,1,-7,43,49,-6,-6,0,0,-8
Washington Capitals,2014/03/11  vs. PIT,PIT,1,44,43,1,-9,0,10,-8,36,35,1,-6,0,7,-7
Ottawa Senators,2014/03/18  vs. NYR,NYR,1,65,55,10,1,3,6,7,48,43,5,2,2,1,7
Nashville Predators,2014/04/10  vs. PHX,PHX,1,32,53,-21,-1,-20,0,-6,29,38,-9,3,-12,0,1
Florida Panthers,2014/01/24  vs. COL,COL,1,53,28,25,0,0,25,2,47,25,22,1,0,21,2
Philadelphia Flyers,2014/02/08  vs. CGY,CGY,1,37,60,-23,-4,-19,0,-16,27,45,-18,-6,-12,0,-12
Nashville Predators,2014/03/06  vs. STL,STL,1,31,27,4,9,0,-5,5,22,25,-3,4,0,-7,1
Calgary Flames,2014/03/15  vs. PHX,PHX,1,37,33,4,7,0,-3,7,26,24,2,5,0,-3,8
St. Louis Blues,2014/04/03  vs. BUF,BUF,1,62,36,26,17,9,0,19,43,26,17,11,6,0,11
Dallas Stars,2013/12/19  vs. VAN,VAN,1,46,40,6,7,-1,0,2,31,29,2,5,-3,0,-2
Carolina Hurricanes,2013/12/31  vs. MTL,MTL,1,52,25,27,2,2,23,4,32,19,13,3,1,9,5
Dallas Stars,2014/03/03  vs. BUF,BUF,1,54,40,14,12,5,-3,9,41,32,9,7,4,-2,5
Phoenix Coyotes,2013/11/09  vs. WSH,WSH,1,38,34,4,-2,2,4,-2,30,27,3,-1,0,4,-2
Nashville Predators,2013/10/19  vs. MTL,MTL,1,42,36,6,5,1,0,6,34,25,9,8,1,0,9
Montreal Canadiens,2014/01/30  vs. BOS,BOS,1,49,53,-4,7,-11,0,-12,37,38,-1,5,-6,0,-10
Carolina Hurricanes,2013/10/15  vs. CHI,CHI,1,53,55,-2,-10,0,8,-11,35,44,-9,-10,0,1,-11
Carolina Hurricanes,2014/04/01  vs. PIT,PIT,1,41,49,-8,-7,0,-1,-5,29,33,-4,-5,1,0,-1
Tampa Bay Lightning,2013/11/19  vs. LAK,LAK,1,29,42,-13,-5,0,-8,-6,25,37,-12,-4,0,-8,-5
Edmonton Oilers,2013/10/14  vs. WSH,WSH,1,41,40,1,3,1,-3,2,31,26,5,8,-1,-2,7
Calgary Flames,2014/03/22  vs. EDM,EDM,1,50,43,7,-2,6,3,4,42,31,11,-1,8,4,6
Minnesota Wild,2014/04/05  vs. PIT,PIT,1,30,38,-8,-4,-4,0,-4,22,24,-2,-2,0,0,-3
Nashville Predators,2013/11/02  vs. LAK,LAK,1,31,68,-37,-6,-31,0,-12,23,48,-25,0,-25,0,-5
Phoenix Coyotes,2013/12/17  vs. MTL,MTL,1,54,44,10,-6,13,3,6,34,32,2,-7,9,0,0
Pittsburgh Penguins,2013/11/23  vs. MTL,MTL,1,48,41,7,-5,0,12,2,36,27,9,-2,0,11,3
Boston Bruins,2014/03/21  vs. COL,COL,1,44,36,8,-2,10,0,-9,33,27,6,0,6,0,-9
Chicago Blackhawks,2013/10/24  vs. TBL,TBL,1,51,24,27,8,-1,20,27,40,21,19,9,-4,14,22
Edmonton Oilers,2013/10/12  vs. TOR,TOR,1,40,46,-6,-8,2,0,-2,29,28,1,-4,5,0,3
Pittsburgh Penguins,2013/10/05  vs. BUF,BUF,1,55,32,23,5,18,0,8,41,18,23,3,20,0,6
Los Angeles Kings,2014/03/03  vs. MTL,MTL,1,40,25,15,0,15,0,9,28,21,7,-1,8,0,4
Pittsburgh Penguins,2013/11/13  vs. PHI,PHI,1,50,34,16,7,0,9,8,37,24,13,10,0,3,9
Calgary Flames,2013/11/08  vs. COL,COL,1,60,39,21,-7,0,28,13,45,26,19,-3,0,22,13
Tampa Bay Lightning,2013/12/10  vs. WSH,WSH,1,54,23,31,9,22,0,18,38,20,18,6,12,0,9
Carolina Hurricanes,2014/03/27  vs. FLA,FLA,1,41,49,-8,0,-8,0,3,31,44,-13,1,-14,0,1
Phoenix Coyotes,2014/01/30  vs. BUF,BUF,1,54,41,13,5,-8,16,3,39,30,9,6,-6,9,4
Carolina Hurricanes,2013/11/16  vs. STL,STL,1,30,49,-19,-19,0,0,-20,23,36,-13,-12,0,-1,-13
New York Rangers,2013/11/06  vs. PIT,PIT,1,42,28,14,2,12,0,3,35,24,11,1,10,0,2
Buffalo Sabres,2013/11/07  vs. LAK,LAK,1,27,32,-5,-2,0,-3,2,19,24,-5,-1,0,-4,-3
Phoenix Coyotes,2013/12/03  vs. EDM,EDM,1,36,45,-9,-8,-1,0,-9,31,34,-3,-3,0,0,-4
Buffalo Sabres,2014/03/09  vs. CHI,CHI,1,22,42,-20,-16,0,-4,-15,16,28,-12,-9,0,-3,-9
Tampa Bay Lightning,2014/02/08  vs. DET,DET,1,37,52,-15,-11,0,-4,-15,28,41,-13,-7,-1,-5,-12
Nashville Predators,2014/01/18  vs. COL,COL,1,53,38,15,-2,0,17,-3,38,31,7,-2,0,9,-3
New Jersey Devils,2014/03/23  vs. TOR,TOR,1,35,28,7,1,6,0,4,31,20,11,2,9,0,6
Buffalo Sabres,2013/12/19  vs. BOS,BOS,1,33,58,-25,-23,2,-4,-27,20,38,-18,-15,1,-4,-19
Edmonton Oilers,2014/01/27  vs. VAN,VAN,1,42,47,-5,-4,-1,0,-4,25,32,-7,-4,-3,0,-5
Tampa Bay Lightning,2013/11/09  vs. DET,DET,1,47,35,12,9,2,1,9,39,23,16,7,6,3,11
Vancouver Canucks,2014/02/03  vs. DET,DET,1,22,37,-15,-6,0,-9,-6,20,31,-11,-4,0,-7,-4
Buffalo Sabres,2013/10/17  vs. VAN,VAN,1,34,42,-8,-6,0,-2,-8,19,34,-15,-7,0,-8,-12
Colorado Avalanche,2013/10/08  vs. TOR,TOR,1,47,53,-6,-8,-3,5,-3,38,38,0,-4,0,4,0
Chicago Blackhawks,2013/10/11  vs. NYI,NYI,1,54,30,24,7,17,0,16,35,19,16,7,9,0,12
Colorado Avalanche,2014/03/12  vs. CHI,CHI,1,42,45,-3,2,-5,0,2,28,34,-6,-2,-4,0,-3
Columbus Blue Jackets,2013/11/30  vs. BOS,BOS,1,29,51,-22,-3,0,-19,-10,16,38,-22,-2,0,-20,-9
Detroit Red Wings,2013/12/04  vs. PHI,PHI,1,32,40,-8,-6,-2,0,-6,31,32,-1,-3,1,1,-2
Nashville Predators,2013/11/23  vs. NYR,NYR,1,28,50,-22,-10,0,-12,-20,24,42,-18,-11,0,-7,-17
Chicago Blackhawks,2013/12/15  vs. LAK,LAK,1,47,27,20,2,18,0,1,41,19,22,2,20,0,3
Montreal Canadiens,2013/12/31  vs. CAR,CAR,1,25,52,-27,-2,-23,-2,-4,19,32,-13,-3,-9,-1,-5
Ottawa Senators,2014/02/03  vs. PIT,PIT,1,39,50,-11,-13,2,0,-11,30,39,-9,-11,2,0,-9
Detroit Red Wings,2014/01/16  vs. NYR,NYR,1,42,62,-20,-19,0,-1,-19,37,50,-13,-11,0,-2,-11
New York Rangers,2014/03/22  vs. NJD,NJD,1,28,40,-12,-1,-11,0,-3,24,29,-5,2,-7,0,1
Edmonton Oilers,2013/10/29  vs. TOR,TOR,1,65,42,23,2,0,21,7,45,31,14,1,0,13,3
Pittsburgh Penguins,2014/03/16  vs. PHI,PHI,1,32,45,-13,-2,0,-11,-6,23,35,-12,0,0,-12,-6
Nashville Predators,2013/12/21  vs. MTL,MTL,1,52,38,14,6,0,8,6,39,32,7,4,0,3,3
St. Louis Blues,2014/01/18  vs. ANA,ANA,1,58,36,22,1,0,21,4,42,26,16,-1,0,17,3
Detroit Red Wings,2014/04/09  vs. PIT,PIT,1,53,37,16,-1,11,6,10,38,26,12,0,6,6,6
New Jersey Devils,2013/12/02  vs. MTL,MTL,1,54,31,23,16,10,-3,30,35,19,16,10,9,-3,21
Pittsburgh Penguins,2014/01/27  vs. BUF,BUF,1,42,31,11,10,1,0,10,37,25,12,9,3,0,10
Philadelphia Flyers,2013/11/29  vs. WPG,WPG,1,48,38,10,1,9,0,10,33,26,7,1,6,0,10
Chicago Blackhawks,2013/10/12  vs. BUF,BUF,1,41,38,3,2,1,0,15,33,29,4,2,2,0,10
Montreal Canadiens,2014/02/27  vs. PIT,PIT,1,36,32,4,5,-1,0,4,28,23,5,5,1,-1,5
Carolina Hurricanes,2014/01/19  vs. TBL,TBL,1,76,34,42,14,0,28,15,54,27,27,8,0,19,8
Minnesota Wild,2013/10/22  vs. NSH,NSH,1,60,39,21,18,3,0,19,41,23,18,18,0,0,18
Phoenix Coyotes,2013/11/27  vs. MIN,MIN,1,29,48,-19,2,-21,0,-5,25,34,-9,3,-12,0,0
Philadelphia Flyers,2013/12/04  vs. DET,DET,1,40,32,8,6,0,2,6,32,31,1,3,-1,-1,2
Dallas Stars,2014/03/28  vs. NSH,NSH,1,48,64,-16,-2,-14,0,6,33,46,-13,1,-14,0,7
San Jose Sharks,2014/03/20  vs. ANA,ANA,1,54,36,18,4,7,7,13,43,23,20,5,12,3,18
Toronto Maple Leafs,2013/10/01  vs. MTL,MTL,1,39,56,-17,3,-9,-11,-9,26,44,-18,0,-8,-10,-11
Phoenix Coyotes,2014/03/24  vs. NYR,NYR,1,32,55,-23,-12,-11,0,-13,21,41,-20,-11,-9,0,-11
Chicago Blackhawks,2014/03/16  vs. DET,DET,1,42,34,8,15,-7,0,15,27,27,0,6,-6,0,6
Phoenix Coyotes,2013/12/19  vs. TOR,TOR,1,63,37,26,3,0,23,14,43,27,16,3,0,13,10
Boston Bruins,2014/02/04  vs. VAN,VAN,1,53,53,0,-4,4,0,-17,44,39,5,-2,7,0,-10
New York Rangers,2014/03/24  vs. PHX,PHX,1,55,32,23,12,0,11,13,41,21,20,11,0,9,11
Boston Bruins,2014/03/12  vs. MTL,MTL,1,43,55,-12,-4,-8,0,-2,32,41,-9,-5,-4,0,-4
San Jose Sharks,2014/03/25  vs. EDM,EDM,1,52,54,-2,0,-9,7,5,38,35,3,2,-8,9,7
Winnipeg Jets,2014/03/29  vs. LAK,LAK,1,45,50,-5,-3,0,-2,-4,37,39,-2,-3,0,1,-5
San Jose Sharks,2013/12/14  vs. NSH,NSH,1,45,32,13,0,0,13,0,35,23,12,0,0,12,0
Chicago Blackhawks,2013/10/28  vs. MIN,MIN,1,46,44,2,-2,4,0,-1,33,31,2,-5,7,0,-5
Buffalo Sabres,2014/04/03  vs. STL,STL,1,36,62,-26,-17,0,-9,-19,26,43,-17,-11,0,-6,-11
Colorado Avalanche,2013/11/27  vs. STL,STL,1,41,47,-6,-4,0,-2,0,24,37,-13,-3,0,-10,-2
Toronto Maple Leafs,2013/12/16  vs. PIT,PIT,1,38,40,-2,1,0,-3,-3,25,33,-8,1,0,-9,-8
New Jersey Devils,2013/10/08  vs. VAN,VAN,1,32,47,-15,-8,-7,0,-15,30,35,-5,-1,-4,0,-5
St. Louis Blues,2013/12/10  vs. WPG,WPG,1,43,25,18,14,4,0,17,25,17,8,8,0,0,8
Minnesota Wild,2014/04/08  vs. BOS,BOS,1,36,38,-2,-7,-1,6,-8,28,21,7,4,-1,4,3
Colorado Avalanche,2013/11/14  vs. STL,STL,1,37,39,-2,-8,0,6,-1,28,29,-1,-3,0,2,2
Buffalo Sabres,2013/10/25  vs. FLA,FLA,1,30,71,-41,-16,-3,-22,-38,23,56,-33,-10,-5,-18,-28
Boston Bruins,2014/01/28  vs. FLA,FLA,1,53,46,7,7,0,0,11,44,38,6,4,2,0,8
Anaheim Ducks,2013/10/02  vs. COL,COL,1,49,40,9,2,0,7,1,38,32,6,0,0,6,0
Ottawa Senators,2013/12/23  vs. PIT,PIT,1,48,35,13,3,10,0,1,37,25,12,2,10,0,-1
Phoenix Coyotes,2014/03/06  vs. MTL,MTL,1,34,41,-7,6,-13,0,3,25,28,-3,5,-8,0,4
Anaheim Ducks,2013/12/15  vs. EDM,EDM,1,57,34,23,7,19,-3,10,43,28,15,6,13,-4,7
Chicago Blackhawks,2013/11/30  vs. PHX,PHX,1,45,45,0,1,-1,0,6,33,36,-3,0,-3,0,3
New York Islanders,2014/01/14  vs. FLA,FLA,1,46,34,12,0,0,12,-1,36,27,9,0,0,9,-3
Winnipeg Jets,2013/11/21  vs. CHI,CHI,1,34,41,-7,-4,0,-3,-3,23,29,-6,-3,0,-3,-3
Edmonton Oilers,2014/02/03  vs. BUF,BUF,1,31,53,-22,-1,-13,-8,-16,26,43,-17,-1,-10,-6,-10
San Jose Sharks,2014/01/27  vs. LAK,LAK,1,43,40,3,-13,0,16,-11,23,21,2,-7,0,9,-6
Buffalo Sabres,2014/03/07  vs. FLA,FLA,1,36,36,0,0,0,0,-7,25,30,-5,0,0,-5,-6
Tampa Bay Lightning,2013/10/03  vs. BOS,BOS,1,38,47,-9,2,0,-11,-1,29,31,-2,5,0,-7,2
Dallas Stars,2013/10/20  vs. ANA,ANA,1,48,46,2,2,-2,2,4,36,35,1,2,-2,1,3
Carolina Hurricanes,2014/02/27  vs. DAL,DAL,1,32,34,-2,0,0,-2,0,24,24,0,1,0,-1,1
Winnipeg Jets,2014/01/21  vs. ANA,ANA,1,37,74,-37,-11,-25,-1,-25,34,45,-11,-2,-8,-1,-11
Los Angeles Kings,2013/11/07  vs. BUF,BUF,1,32,27,5,2,3,0,-2,24,19,5,1,4,0,3
Boston Bruins,2013/10/23  vs. BUF,BUF,1,34,29,5,1,4,0,5,24,21,3,1,2,0,4
Ottawa Senators,2014/04/08  vs. NYI,NYI,1,41,43,-2,3,-5,0,-1,36,38,-2,3,-5,0,-1
New Jersey Devils,2014/03/01  vs. NYI,NYI,1,39,28,11,0,11,0,-4,26,17,9,0,9,0,-5
Philadelphia Flyers,2013/10/15  vs. VAN,VAN,1,43,49,-6,-1,-5,0,-8,32,33,-1,5,-6,0,-2
Minnesota Wild,2014/04/07  vs. WPG,WPG,1,30,38,-8,-2,-6,0,2,19,25,-6,-1,-5,0,2
Edmonton Oilers,2014/01/14  vs. DAL,DAL,1,54,53,1,-1,0,2,-2,40,40,0,-3,0,3,-4
Boston Bruins,2013/12/07  vs. PIT,PIT,1,28,33,-5,-3,1,-3,-1,16,22,-6,-1,1,-6,0
St. Louis Blues,2014/03/02  vs. PHX,PHX,1,41,40,1,-6,1,6,-9,37,27,10,-1,2,9,0
Chicago Blackhawks,2013/12/10  vs. DAL,DAL,1,44,42,2,-1,3,0,1,33,29,4,0,4,0,3
New Jersey Devils,2013/12/20  vs. ANA,ANA,1,24,22,2,6,-4,0,2,20,18,2,5,-3,0,2
Calgary Flames,2013/11/16  vs. EDM,EDM,1,51,33,18,10,14,-6,14,39,26,13,9,10,-6,12
Chicago Blackhawks,2014/04/03  vs. MIN,MIN,1,45,47,-2,-1,-2,1,0,30,32,-2,-5,2,1,-4
Nashville Predators,2014/01/07  vs. SJS,SJS,1,42,42,0,4,-4,0,4,36,30,6,5,1,0,7
Washington Capitals,2013/12/30  vs. OTT,OTT,1,55,44,11,0,3,8,12,42,37,5,0,4,1,8
Toronto Maple Leafs,2014/04/05  vs. WPG,WPG,1,28,64,-36,-21,-3,-12,-28,23,53,-30,-19,-1,-10,-22
Vancouver Canucks,2013/12/17  vs. MIN,MIN,1,39,41,-2,-1,-1,0,0,32,29,3,1,2,0,4
Carolina Hurricanes,2014/01/13  vs. CGY,CGY,1,42,46,-4,-6,0,2,-6,29,36,-7,-4,0,-3,-5
Anaheim Ducks,2014/03/28  vs. EDM,EDM,1,62,29,33,15,4,14,25,49,22,27,13,4,10,22
Colorado Avalanche,2013/10/02  vs. ANA,ANA,1,40,49,-9,-2,-7,0,-1,32,38,-6,0,-6,0,0
San Jose Sharks,2013/12/10  vs. NYI,NYI,1,70,50,20,16,4,0,18,52,30,22,15,7,0,15
Calgary Flames,2013/12/12  vs. CAR,CAR,1,41,52,-11,-6,-5,0,-6,32,35,-3,3,-6,0,3
New York Rangers,2013/10/24  vs. PHI,PHI,1,55,33,22,2,0,20,7,40,27,13,4,0,9,6
New Jersey Devils,2014/01/12  vs. TOR,TOR,1,60,34,26,29,0,-3,26,43,23,20,21,0,-1,20
Edmonton Oilers,2013/10/05  vs. VAN,VAN,1,28,37,-9,-9,0,0,-11,19,25,-6,-7,0,1,-8
San Jose Sharks,2013/12/05  vs. PIT,PIT,1,59,47,12,-3,0,15,-1,43,32,11,-3,0,14,-3
Chicago Blackhawks,2013/11/21  vs. WPG,WPG,1,41,34,7,4,3,0,3,29,23,6,3,3,0,3
New Jersey Devils,2013/10/03  vs. PIT,PIT,1,54,35,19,-2,0,21,-1,34,26,8,-5,0,13,-5
Montreal Canadiens,2014/01/06  vs. FLA,FLA,1,46,62,-16,-11,-5,0,1,37,38,-1,0,-1,0,9
Ottawa Senators,2014/01/11  vs. NSH,NSH,1,49,44,5,1,4,0,5,37,35,2,-1,3,0,2
Phoenix Coyotes,2014/01/22  vs. CGY,CGY,1,54,35,19,-4,0,23,0,35,28,7,-3,0,10,0
New Jersey Devils,2013/10/04  vs. NYI,NYI,1,45,32,13,7,7,-1,14,35,25,10,5,6,-1,11
Calgary Flames,2014/02/01  vs. MIN,MIN,1,34,34,0,1,-1,0,9,29,26,3,0,3,0,9
Detroit Red Wings,2013/11/23  vs. OTT,OTT,1,37,22,15,12,1,2,13,31,20,11,7,1,3,9
San Jose Sharks,2014/04/01  vs. EDM,EDM,1,37,31,6,3,-3,6,-1,27,23,4,3,-2,3,2
Tampa Bay Lightning,2014/03/10  vs. PHX,PHX,1,44,46,-2,-7,1,4,-7,27,33,-6,-6,-2,2,-8
Phoenix Coyotes,2013/10/24  vs. LAK,LAK,1,37,37,0,2,0,-2,2,28,32,-4,1,0,-5,1
Colorado Avalanche,2014/01/18  vs. NSH,NSH,1,38,53,-15,2,-17,0,3,31,38,-7,2,-9,0,3
Boston Bruins,2013/10/19  vs. TBL,TBL,1,26,29,-3,0,-3,0,-2,19,24,-5,-1,-4,0,-5
Toronto Maple Leafs,2014/01/15  vs. BUF,BUF,1,49,47,2,5,-3,0,2,38,36,2,7,-5,0,2
Anaheim Ducks,2013/10/27  vs. CBJ,CBJ,1,36,37,-1,1,-4,2,-3,26,26,0,4,-2,-2,-2
New York Rangers,2014/03/21  vs. CBJ,CBJ,1,39,46,-7,0,-5,-2,0,28,32,-4,0,-2,-2,0
Tampa Bay Lightning,2013/11/02  vs. STL,STL,1,41,38,3,-4,6,1,0,28,28,0,-4,5,-1,-3
New Jersey Devils,2014/01/03  vs. CHI,CHI,1,36,31,5,2,0,3,2,28,25,3,2,0,1,2
Boston Bruins,2014/03/02  vs. NYR,NYR,1,58,60,-2,0,2,-4,-4,43,46,-3,0,5,-8,-11
Columbus Blue Jackets,2013/11/14  vs. BOS,BOS,1,42,53,-11,-9,-6,4,-11,34,35,-1,1,-5,3,-1
Phoenix Coyotes,2014/01/24  vs. EDM,EDM,1,47,50,-3,2,-5,0,1,33,40,-7,-1,-6,0,-1
Colorado Avalanche,2014/04/13  vs. ANA,ANA,1,52,57,-5,15,-20,0,-2,38,52,-14,6,-20,0,-11
Detroit Red Wings,2014/01/22  vs. CHI,CHI,1,44,38,6,3,3,0,6,35,30,5,1,4,0,5
Colorado Avalanche,2014/03/27  vs. VAN,VAN,1,43,46,-3,-5,0,2,-3,32,29,3,-1,4,0,3
Los Angeles Kings,2014/04/09  vs. CGY,CGY,1,73,42,31,12,0,19,30,52,28,24,9,0,15,25
San Jose Sharks,2013/10/03  vs. VAN,VAN,1,46,45,1,-5,-1,7,1,32,34,-2,-2,1,-1,-3
Pittsburgh Penguins,2014/04/13  vs. OTT,OTT,1,32,34,-2,-5,3,0,-2,28,26,2,-1,3,0,2
Anaheim Ducks,2014/02/28  vs. STL,STL,1,29,58,-29,-1,-28,0,-24,26,36,-10,1,-11,0,-10
Vancouver Canucks,2013/11/10  vs. ANA,ANA,1,55,45,10,11,0,-1,6,42,28,14,14,0,0,10
Boston Bruins,2013/12/21  vs. BUF,BUF,1,52,49,3,-1,4,0,7,41,40,1,-1,2,0,7
Dallas Stars,2013/11/05  vs. BOS,BOS,1,40,44,-4,1,-1,-4,0,35,30,5,9,0,-4,9
Calgary Flames,2014/03/30  vs. OTT,OTT,1,49,61,-12,-3,-1,-8,-3,41,47,-6,0,1,-7,2
Winnipeg Jets,2013/10/27  vs. COL,COL,1,42,62,-20,-12,-2,-6,-9,32,46,-14,-11,0,-3,-5
Detroit Red Wings,2014/02/26  vs. MTL,MTL,1,57,38,19,1,18,0,18,37,20,17,2,15,0,11
San Jose Sharks,2014/01/05  vs. CHI,CHI,1,55,52,3,2,-1,2,-2,41,39,2,-1,3,0,-1
Calgary Flames,2014/03/01  vs. EDM,EDM,1,47,54,-7,-3,-4,0,-10,33,32,1,0,1,0,-4
Columbus Blue Jackets,2013/12/03  vs. TBL,TBL,1,38,37,1,-4,5,0,6,28,29,-1,-4,3,0,4
Columbus Blue Jackets,2013/10/17  vs. MTL,MTL,1,41,44,-3,1,0,-4,5,28,33,-5,-1,0,-4,3
Pittsburgh Penguins,2013/10/11  vs. FLA,FLA,1,50,37,13,5,0,8,5,38,29,9,1,0,8,1
Tampa Bay Lightning,2013/12/15  vs. DET,DET,1,43,43,0,3,-3,0,3,33,30,3,3,0,0,3
Calgary Flames,2014/01/13  vs. CAR,CAR,1,46,42,4,6,-2,0,6,36,29,7,4,3,0,5
Phoenix Coyotes,2013/10/26  vs. EDM,EDM,1,34,39,-5,-1,-2,-2,-7,26,31,-5,-2,0,-3,-6
Columbus Blue Jackets,2014/01/18  vs. BUF,BUF,1,56,29,27,14,9,4,18,39,23,16,10,2,4,13
Phoenix Coyotes,2013/10/13  vs. CAR,CAR,1,43,35,8,6,-1,3,12,37,26,11,5,3,3,13
New Jersey Devils,2013/12/31  vs. PIT,PIT,1,44,36,8,1,7,0,14,34,27,7,0,7,0,10
Boston Bruins,2013/11/27  vs. DET,DET,1,29,30,-1,-2,0,1,1,19,26,-7,-3,0,-4,-1
Montreal Canadiens,2013/11/22  vs. WSH,WSH,1,42,53,-11,-4,-7,0,0,28,39,-11,-3,-8,0,1
Phoenix Coyotes,2013/12/06  vs. VAN,VAN,1,56,42,14,-1,0,15,-1,40,34,6,-2,0,8,-4
Winnipeg Jets,2013/10/15  vs. MTL,MTL,1,61,37,24,-8,0,32,-9,42,31,11,-5,0,16,-7
Minnesota Wild,2014/02/06  vs. NSH,NSH,1,40,38,2,3,-1,0,2,26,30,-4,-6,2,0,-4
Pittsburgh Penguins,2013/12/27  vs. CAR,CAR,1,45,63,-18,-6,-1,-11,-17,37,46,-9,-4,-1,-4,-8
Anaheim Ducks,2013/11/08  vs. BUF,BUF,1,66,49,17,3,14,0,6,60,36,24,3,21,0,7
Philadelphia Flyers,2013/11/09  vs. EDM,EDM,1,47,32,15,-6,21,0,-3,34,22,12,-3,15,0,-2
Vancouver Canucks,2014/03/06  vs. DAL,DAL,1,41,36,5,-4,0,9,-9,30,25,5,-1,0,6,-5
New York Rangers,2014/01/12  vs. PHI,PHI,1,48,44,4,7,-3,0,8,36,31,5,5,0,0,6
Boston Bruins,2013/12/12  vs. EDM,EDM,1,42,58,-16,4,-20,0,5,30,44,-14,3,-17,0,3
Chicago Blackhawks,2014/02/05  vs. ANA,ANA,1,36,43,-7,-6,-1,0,-5,29,27,2,-2,4,0,1
Chicago Blackhawks,2014/03/06  vs. CBJ,CBJ,1,42,29,13,-2,15,0,4,31,24,7,-3,10,0,2
Montreal Canadiens,2013/10/05  vs. PHI,PHI,1,45,25,20,0,20,0,9,31,16,15,-1,16,0,6
Washington Capitals,2014/04/05  vs. NYI,NYI,1,40,50,-10,-13,0,3,-13,28,38,-10,-11,0,1,-12
Washington Capitals,2014/03/30  vs. NSH,NSH,1,22,40,-18,-9,-1,-8,-16,18,33,-15,-7,-1,-7,-13
Chicago Blackhawks,2013/11/27  vs. CGY,CGY,1,64,33,31,17,1,13,16,39,26,13,8,1,4,4
Montreal Canadiens,2013/11/27  vs. BUF,BUF,1,42,39,3,8,-5,0,7,32,26,6,4,2,0,5
New York Islanders,2013/12/28  vs. NJD,NJD,1,50,47,3,-7,0,10,-2,32,32,0,-5,0,5,-2
Buffalo Sabres,2013/12/29  vs. WSH,WSH,1,38,56,-18,-17,-1,0,-17,27,45,-18,-17,-1,0,-17
Montreal Canadiens,2014/03/03  vs. LAK,LAK,1,25,40,-15,0,0,-15,-9,21,28,-7,1,0,-8,-4
Edmonton Oilers,2013/11/19  vs. CBJ,CBJ,1,44,38,6,1,5,0,11,35,26,9,1,8,0,9
Boston Bruins,2014/03/13  vs. PHX,PHX,1,37,33,4,-1,5,0,3,28,21,7,0,7,0,2
Columbus Blue Jackets,2013/11/22  vs. VAN,VAN,1,28,45,-17,-3,-12,-2,-16,16,33,-17,-3,-5,-9,-9
Vancouver Canucks,2014/04/01  vs. NYR,NYR,1,51,38,13,2,0,11,3,40,29,11,2,0,9,4
Washington Capitals,2013/10/22  vs. WPG,WPG,1,38,48,-10,-2,0,-8,-5,31,41,-10,-1,-1,-8,-5
Los Angeles Kings,2013/10/11  vs. CAR,CAR,1,53,42,11,11,0,0,11,45,27,18,18,0,0,18
Los Angeles Kings,2013/12/28  vs. NSH,NSH,1,51,33,18,13,0,5,15,34,27,7,4,0,3,5
Calgary Flames,2013/12/31  vs. PHI,PHI,1,53,33,20,5,0,15,10,32,27,5,6,0,-1,3
Minnesota Wild,2014/01/07  vs. LAK,LAK,1,29,64,-35,-34,0,-1,-34,20,49,-29,-28,0,-1,-28
Phoenix Coyotes,2014/03/11  vs. FLA,FLA,1,35,45,-10,3,-13,0,0,31,39,-8,2,-10,0,0
New York Islanders,2014/03/18  vs. MIN,MIN,1,49,42,7,9,0,-2,11,30,26,4,7,0,-3,8
San Jose Sharks,2013/10/30  vs. LAK,LAK,1,25,43,-18,-11,-7,0,-14,20,29,-9,-7,-2,0,-8
Pittsburgh Penguins,2013/10/21  vs. COL,COL,1,44,23,21,8,0,13,14,29,15,14,5,0,9,9
Los Angeles Kings,2013/11/23  vs. COL,COL,1,31,40,-9,-9,0,0,-9,21,35,-14,-14,0,0,-14
Anaheim Ducks,2014/03/18  vs. WSH,WSH,1,53,44,9,6,0,3,2,44,33,11,8,0,3,4
Edmonton Oilers,2013/12/12  vs. BOS,BOS,1,58,42,16,-4,0,20,-5,44,30,14,-3,0,17,-3
Nashville Predators,2013/10/15  vs. FLA,FLA,1,47,43,4,-1,5,0,1,37,34,3,0,3,0,0
Dallas Stars,2014/01/10  vs. NYR,NYR,1,52,51,1,-2,4,-1,2,42,38,4,0,6,-2,6
Buffalo Sabres,2013/12/14  vs. CGY,CGY,1,45,31,14,14,0,0,14,29,25,4,6,-2,0,6
Dallas Stars,2014/03/08  vs. MIN,MIN,1,49,48,1,-2,0,3,0,37,39,-2,-1,-4,3,-3
Los Angeles Kings,2013/11/17  vs. NYR,NYR,1,56,38,18,4,14,0,18,39,30,9,-4,13,0,8
Pittsburgh Penguins,2014/03/25  vs. PHX,PHX,1,45,41,4,5,0,-1,-1,28,32,-4,2,0,-6,-6
Vancouver Canucks,2013/12/30  vs. PHI,PHI,1,45,36,9,8,1,0,11,36,25,11,8,1,2,13
Winnipeg Jets,2013/10/11  vs. DAL,DAL,1,46,37,9,-6,0,15,-6,36,31,5,-4,0,9,-5
Vancouver Canucks,2014/03/16  vs. FLA,FLA,1,47,36,11,8,6,-3,13,38,26,12,8,7,-3,13
Detroit Red Wings,2014/03/20  vs. PIT,PIT,1,32,34,-2,-3,1,0,-5,23,27,-4,-6,2,0,-8
Los Angeles Kings,2013/12/15  vs. CHI,CHI,1,27,47,-20,-2,0,-18,-1,19,41,-22,-2,0,-20,-3
Florida Panthers,2013/11/16  vs. COL,COL,1,40,51,-11,1,-12,0,-6,32,42,-10,-2,-8,0,-6
Anaheim Ducks,2014/03/20  vs. SJS,SJS,1,36,54,-18,-4,-7,-7,-13,23,43,-20,-5,-3,-12,-18
Vancouver Canucks,2014/01/18  vs. CGY,CGY,1,45,45,0,1,0,-1,1,30,34,-4,-3,0,-1,-3
Vancouver Canucks,2014/01/27  vs. EDM,EDM,1,47,42,5,4,0,1,4,32,25,7,4,0,3,5
Columbus Blue Jackets,2014/01/11  vs. WPG,WPG,1,40,39,1,-2,-3,6,7,33,29,4,-4,3,5,4
St. Louis Blues,2014/02/28  vs. ANA,ANA,1,58,29,29,1,0,28,24,36,26,10,-1,0,11,10
New York Rangers,2014/03/01  vs. PHI,PHI,1,55,45,10,-5,0,15,6,38,31,7,-4,0,11,4
Los Angeles Kings,2013/12/14  vs. OTT,OTT,1,41,56,-15,0,-15,0,-2,29,43,-14,0,-14,0,0
Winnipeg Jets,2013/12/02  vs. NYR,NYR,1,37,55,-18,-10,-7,-1,-17,33,37,-4,-2,-4,2,-3
Buffalo Sabres,2014/04/06  vs. PHI,PHI,1,28,56,-28,-1,0,-27,-22,19,40,-21,-2,0,-19,-14
Washington Capitals,2013/12/21  vs. NJD,NJD,1,32,66,-34,-10,-11,-13,-26,25,45,-20,-9,-6,-5,-15
New York Rangers,2014/03/09  vs. DET,DET,1,47,38,9,2,7,0,5,33,30,3,1,2,0,2
Winnipeg Jets,2013/10/04  vs. LAK,LAK,1,40,47,-7,-3,-4,0,0,31,35,-4,-4,1,-1,-1
Edmonton Oilers,2014/01/07  vs. STL,STL,1,33,48,-15,-8,0,-7,-8,25,35,-10,-6,0,-4,-5
Colorado Avalanche,2013/10/10  vs. BOS,BOS,1,38,50,-12,8,-20,0,-5,24,41,-17,3,-20,0,-11
Columbus Blue Jackets,2014/03/06  vs. CHI,CHI,1,29,42,-13,2,0,-15,-4,24,31,-7,3,0,-10,-2
New York Rangers,2014/04/05  vs. OTT,OTT,1,70,55,15,8,0,7,10,51,43,8,5,0,3,7
Tampa Bay Lightning,2014/03/13  vs. FLA,FLA,1,45,37,8,6,-1,3,13,34,30,4,3,1,0,6
Detroit Red Wings,2014/01/31  vs. WSH,WSH,1,45,37,8,0,5,3,4,37,27,10,1,6,3,4
Calgary Flames,2014/01/16  vs. WPG,WPG,1,38,38,0,0,0,0,-2,29,25,4,0,0,4,-3
Ottawa Senators,2014/03/25  vs. FLA,FLA,1,55,59,-4,3,-7,0,-3,47,50,-3,5,-8,0,-2
Vancouver Canucks,2013/10/28  vs. WSH,WSH,1,44,28,16,20,-3,-1,19,35,19,16,16,1,-1,16
Columbus Blue Jackets,2014/01/23  vs. PHI,PHI,1,39,26,13,5,4,4,9,30,19,11,3,6,2,6
St. Louis Blues,2014/01/25  vs. NYI,NYI,1,43,36,7,-4,0,11,3,36,28,8,-4,0,12,4
Columbus Blue Jackets,2013/11/15  vs. MTL,MTL,1,34,47,-13,-18,5,0,-14,26,34,-8,-13,5,0,-9
Washington Capitals,2014/01/02  vs. CAR,CAR,1,63,44,19,15,2,2,19,47,35,12,10,2,0,12
Minnesota Wild,2014/01/30  vs. COL,COL,1,48,48,0,-4,0,4,-6,38,43,-5,-7,0,2,-11
Buffalo Sabres,2014/01/14  vs. PHI,PHI,1,27,46,-19,-4,-15,0,-10,21,32,-11,-1,-10,0,-5
Phoenix Coyotes,2013/12/31  vs. EDM,EDM,1,64,38,26,13,8,5,20,53,26,27,13,6,8,23
Colorado Avalanche,2014/01/16  vs. NJD,NJD,1,47,40,7,-3,10,0,5,36,28,8,-2,10,0,6
Buffalo Sabres,2013/10/15  vs. NYI,NYI,1,49,57,-8,-10,0,2,-7,37,44,-7,-8,0,1,-6
Minnesota Wild,2013/12/06  vs. CBJ,CBJ,1,26,45,-19,0,0,-19,-7,16,38,-22,-1,0,-21,-8
Calgary Flames,2013/12/04  vs. PHX,PHX,1,31,52,-21,-2,-16,-3,0,19,34,-15,0,-11,-4,-1
Minnesota Wild,2013/11/29  vs. COL,COL,1,49,32,17,-2,0,19,6,34,21,13,-1,0,14,4
Ottawa Senators,2013/11/09  vs. FLA,FLA,1,40,48,-8,-1,-7,0,-9,31,39,-8,-1,-7,0,-6
Toronto Maple Leafs,2014/01/20  vs. PHX,PHX,1,36,53,-17,-7,-10,0,-5,29,42,-13,-4,-9,0,-2
Nashville Predators,2013/12/30  vs. DET,DET,1,39,51,-12,-2,-10,0,0,33,35,-2,-1,-1,0,1
New Jersey Devils,2013/10/26  vs. BOS,BOS,1,33,35,-2,-3,0,1,-8,24,30,-6,-3,0,-3,-6
Tampa Bay Lightning,2014/03/15  vs. NJD,NJD,1,38,35,3,-1,4,0,-1,31,28,3,1,2,0,0
Tampa Bay Lightning,2014/04/05  vs. DAL,DAL,1,37,30,7,0,0,7,3,32,26,6,0,0,6,2
Columbus Blue Jackets,2013/11/17  vs. OTT,OTT,1,34,40,-6,5,-11,0,9,24,30,-6,1,-7,0,3
Tampa Bay Lightning,2014/03/20  vs. OTT,OTT,1,20,48,-28,-3,-25,0,-16,15,33,-18,-4,-14,0,-10
Philadelphia Flyers,2014/04/12  vs. PIT,PIT,1,32,47,-15,-15,-4,4,-9,25,35,-10,-10,-4,4,-6
Montreal Canadiens,2014/02/26  vs. DET,DET,1,38,57,-19,-1,0,-18,-18,20,37,-17,-2,0,-15,-11
St. Louis Blues,2013/12/19  vs. MTL,MTL,1,34,31,3,0,3,0,-2,23,22,1,-1,2,0,-2
Nashville Predators,2014/03/08  vs. CBJ,CBJ,1,44,41,3,9,0,-6,9,29,34,-5,1,0,-6,1
New Jersey Devils,2013/12/07  vs. NYR,NYR,1,46,44,2,4,1,-3,4,35,26,9,7,1,1,12
Calgary Flames,2014/03/14  vs. DAL,DAL,1,65,46,19,24,0,-5,23,46,37,9,20,0,-11,17
Anaheim Ducks,2013/10/16  vs. CGY,CGY,1,32,43,-11,2,-13,0,0,21,36,-15,0,-15,0,-5
Dallas Stars,2014/03/04  vs. CBJ,CBJ,1,38,28,10,0,0,10,-4,27,20,7,0,0,7,-5
Buffalo Sabres,2014/02/06  vs. OTT,OTT,1,39,56,-17,-5,0,-12,-16,31,46,-15,-6,0,-9,-16
Winnipeg Jets,2013/11/02  vs. CHI,CHI,1,55,48,7,4,1,2,2,39,31,8,1,2,5,2
Columbus Blue Jackets,2014/01/06  vs. NYR,NYR,1,43,46,-3,8,-11,0,6,32,38,-6,2,-8,0,-1
Dallas Stars,2014/04/13  vs. PHX,PHX,1,17,45,-28,-17,-11,0,-28,14,35,-21,-10,-10,-1,-20
Minnesota Wild,2013/10/28  vs. CHI,CHI,1,44,46,-2,2,0,-4,1,31,33,-2,5,0,-7,5
Winnipeg Jets,2014/03/27  vs. SJS,SJS,1,55,39,16,15,-1,2,17,39,28,11,12,-1,0,12
Vancouver Canucks,2013/12/01  vs. CAR,CAR,1,36,44,-8,3,-11,0,-4,27,30,-3,3,-6,0,-3
Florida Panthers,2014/03/04  vs. BOS,BOS,1,46,44,2,-4,0,6,-4,35,33,2,-4,0,6,-4
Toronto Maple Leafs,2014/04/08  vs. TBL,TBL,1,41,59,-18,-10,0,-8,-12,31,47,-16,-9,0,-7,-11
Anaheim Ducks,2014/04/09  vs. SJS,SJS,1,48,46,2,10,-7,-1,11,38,36,2,9,-6,-1,9
Colorado Avalanche,2013/11/02  vs. MTL,MTL,1,48,44,4,6,-2,0,6,40,32,8,9,-1,0,10
Washington Capitals,2013/11/23  vs. TOR,TOR,1,82,46,36,23,0,13,21,56,33,23,15,0,8,14
Pittsburgh Penguins,2014/04/01  vs. CAR,CAR,1,49,41,8,7,1,0,5,33,29,4,5,0,-1,1
Tampa Bay Lightning,2014/01/11  vs. PHI,PHI,1,35,57,-22,0,-22,0,-11,29,44,-15,0,-15,0,-8
Vancouver Canucks,2014/02/26  vs. STL,STL,1,43,38,5,3,2,0,3,37,29,8,5,3,0,5
San Jose Sharks,2013/11/07  vs. VAN,VAN,1,37,38,-1,-1,2,-2,-4,25,32,-7,-1,1,-7,-6
Florida Panthers,2014/03/29  vs. MTL,MTL,1,45,19,26,-3,0,29,-1,38,16,22,-1,0,23,1
San Jose Sharks,2014/01/30  vs. CGY,CGY,1,45,47,-2,-6,0,4,-2,34,36,-2,-2,0,0,2
Florida Panthers,2013/10/15  vs. NSH,NSH,1,43,47,-4,1,0,-5,-1,34,37,-3,0,0,-3,0
Edmonton Oilers,2014/03/20  vs. BUF,BUF,1,36,39,-3,-1,3,-5,2,27,28,-1,3,1,-5,4
Dallas Stars,2013/12/31  vs. LAK,LAK,1,38,42,-4,-3,3,-4,-4,28,29,-1,0,3,-4,0
Pittsburgh Penguins,2013/12/31  vs. NJD,NJD,1,36,44,-8,-1,0,-7,-14,27,34,-7,0,0,-7,-10
St. Louis Blues,2013/11/07  vs. CGY,CGY,1,38,33,5,0,5,0,5,29,19,10,0,10,0,4
San Jose Sharks,2014/04/05  vs. NSH,NSH,1,60,41,19,11,0,8,12,46,32,14,7,0,7,6
Carolina Hurricanes,2014/04/03  vs. DAL,DAL,1,42,48,-6,-2,-4,0,-1,34,35,-1,-2,1,0,-1
New Jersey Devils,2014/04/04  vs. WSH,WSH,1,39,32,7,4,1,2,6,26,26,0,1,3,-4,-3
Edmonton Oilers,2013/11/10  vs. CHI,CHI,1,25,56,-31,-19,-4,-8,-21,22,38,-16,-11,2,-7,-8
Chicago Blackhawks,2013/12/30  vs. LAK,LAK,1,36,44,-8,-5,-3,0,-20,28,33,-5,-1,-4,0,-15
Chicago Blackhawks,2013/12/20  vs. VAN,VAN,1,40,37,3,8,-5,0,3,32,25,7,7,0,0,3
Colorado Avalanche,2013/12/06  vs. CGY,CGY,1,52,36,16,3,0,13,17,35,26,9,1,-3,11,13
Florida Panthers,2014/02/01  vs. CBJ,CBJ,1,53,43,10,-6,0,16,-10,39,33,6,-5,0,11,-9
Pittsburgh Penguins,2014/01/07  vs. VAN,VAN,1,49,49,0,9,-10,1,0,38,39,-1,4,-6,1,-4
Tampa Bay Lightning,2013/12/28  vs. MTL,MTL,1,44,42,2,3,0,-1,2,31,37,-6,-5,0,-1,-6
Chicago Blackhawks,2013/11/19  vs. COL,COL,1,60,34,26,0,0,26,0,45,26,19,0,0,19,1
Columbus Blue Jackets,2013/12/09  vs. PIT,PIT,1,60,43,17,7,0,10,8,41,31,10,5,0,5,6
Phoenix Coyotes,2014/01/16  vs. VAN,VAN,1,30,25,5,-1,6,0,10,22,21,1,-4,5,0,5
Montreal Canadiens,2013/11/16  vs. NYR,NYR,1,48,60,-12,-19,0,7,-14,30,48,-18,-14,0,-4,-14
Carolina Hurricanes,2014/02/25  vs. BUF,BUF,1,48,24,24,24,0,0,27,37,19,18,18,0,0,21
Montreal Canadiens,2013/12/15  vs. FLA,FLA,1,35,48,-13,-17,0,4,-18,20,30,-10,-9,0,-1,-11
Anaheim Ducks,2013/11/23  vs. PHX,PHX,1,41,55,-14,-3,-11,0,4,32,37,-5,-4,-1,0,0
New Jersey Devils,2013/10/19  vs. NYR,NYR,1,24,29,-5,2,-7,0,-1,20,21,-1,2,-3,0,0
New York Islanders,2014/01/31  vs. NYR,NYR,1,48,59,-11,-11,0,0,-5,33,45,-12,-12,0,0,-7
Pittsburgh Penguins,2014/01/15  vs. WSH,WSH,1,40,48,-8,5,0,-13,-8,31,34,-3,7,0,-10,-3
Dallas Stars,2014/04/06  vs. FLA,FLA,1,37,42,-5,4,-7,-2,3,31,30,1,5,-2,-2,5
Los Angeles Kings,2014/03/27  vs. PIT,PIT,1,44,35,9,0,9,0,0,35,28,7,-2,9,0,-1
Chicago Blackhawks,2013/10/01  vs. WSH,WSH,1,42,34,8,6,1,1,2,30,21,9,1,8,0,4
St. Louis Blues,2013/11/27  vs. COL,COL,1,47,41,6,4,2,0,0,37,24,13,3,10,0,2
Phoenix Coyotes,2013/11/02  vs. SJS,SJS,1,36,52,-16,-4,-13,1,-16,23,35,-12,-6,-5,-1,-12
Washington Capitals,2013/11/07  vs. MIN,MIN,1,41,36,5,1,-2,6,1,28,30,-2,-4,-3,5,-4
Vancouver Canucks,2014/01/05  vs. ANA,ANA,1,32,74,-42,1,-43,0,-11,28,54,-26,3,-29,0,-7
Carolina Hurricanes,2014/03/22  vs. WPG,WPG,1,61,52,9,11,-1,-1,13,44,33,11,8,4,-1,12
Montreal Canadiens,2014/03/27  vs. DET,DET,1,32,42,-10,-2,-8,0,-4,26,33,-7,-3,-4,0,-6
Vancouver Canucks,2014/04/12  vs. EDM,EDM,1,59,38,21,2,0,19,6,45,25,20,1,0,19,7
Edmonton Oilers,2013/12/19  vs. COL,COL,1,42,51,-9,-6,-10,7,-15,34,34,0,-1,-5,6,-6
Los Angeles Kings,2013/10/04  vs. WPG,WPG,1,47,40,7,3,0,4,0,35,31,4,4,1,-1,1
San Jose Sharks,2013/10/12  vs. OTT,OTT,1,53,33,20,8,11,1,10,42,19,23,9,11,3,15
Vancouver Canucks,2013/10/10  vs. SJS,SJS,1,30,48,-18,-4,0,-14,-10,19,35,-16,-3,0,-13,-8
Vancouver Canucks,2014/01/16  vs. PHX,PHX,1,25,30,-5,1,0,-6,-10,21,22,-1,4,0,-5,-5
Pittsburgh Penguins,2014/03/27  vs. LAK,LAK,1,35,44,-9,0,0,-9,0,28,35,-7,2,0,-9,1
New Jersey Devils,2014/03/20  vs. MIN,MIN,1,27,17,10,12,-2,0,16,23,15,8,12,-4,0,14
Dallas Stars,2013/11/01  vs. COL,COL,1,54,34,20,-4,0,24,17,37,25,12,-3,0,15,10
New York Rangers,2014/03/30  vs. EDM,EDM,1,42,26,16,9,7,0,17,34,20,14,7,7,0,12
Los Angeles Kings,2013/11/09  vs. VAN,VAN,1,49,42,7,1,6,0,0,36,34,2,-2,4,0,-3
New York Rangers,2013/12/05  vs. BUF,BUF,1,51,50,1,2,-1,0,9,40,36,4,1,3,0,12
Ottawa Senators,2013/11/23  vs. DET,DET,1,22,37,-15,-12,-2,-1,-13,20,31,-11,-7,-3,-1,-9
Colorado Avalanche,2013/12/29  vs. WPG,WPG,1,55,54,1,2,0,-1,2,37,42,-5,-4,0,-1,-4
Minnesota Wild,2013/12/11  vs. ANA,ANA,1,34,42,-8,0,0,-8,-7,29,37,-8,2,0,-10,-5
Detroit Red Wings,2013/10/02  vs. BUF,BUF,1,43,20,23,6,17,0,7,36,14,22,5,17,0,6
Columbus Blue Jackets,2014/01/25  vs. BUF,BUF,1,84,25,59,7,0,52,32,55,20,35,0,0,35,17
Calgary Flames,2013/10/26  vs. WSH,WSH,1,33,42,-9,3,-12,0,2,29,29,0,2,-2,0,5
Calgary Flames,2014/02/04  vs. MTL,MTL,1,51,61,-10,-12,0,2,-16,34,41,-7,-5,0,-2,-10
Carolina Hurricanes,2014/03/21  vs. CHI,CHI,1,20,29,-9,-7,0,-2,-9,16,20,-4,-8,0,4,-6
Ottawa Senators,2013/12/09  vs. PHI,PHI,1,58,44,14,16,2,-4,12,42,33,9,9,3,-3,6
Boston Bruins,2013/10/17  vs. FLA,FLA,1,56,32,24,6,18,0,16,45,30,15,4,11,0,11
Phoenix Coyotes,2013/12/21  vs. OTT,OTT,1,34,42,-8,-3,0,-5,-13,25,34,-9,-3,0,-6,-12
Tampa Bay Lightning,2013/11/11  vs. BOS,BOS,1,48,39,9,-2,0,11,-3,39,35,4,-2,0,6,-3
New York Islanders,2013/11/05  vs. WSH,WSH,1,42,51,-9,-10,2,-1,-9,31,38,-7,-9,3,-1,-7
Philadelphia Flyers,2013/10/02  vs. TOR,TOR,1,44,33,11,7,0,4,7,29,26,3,5,-4,2,1
Calgary Flames,2014/01/22  vs. PHX,PHX,1,35,54,-19,4,-23,0,0,28,35,-7,3,-10,0,0
Detroit Red Wings,2014/04/04  vs. BUF,BUF,1,57,38,19,3,16,0,-1,37,25,12,3,9,0,1
Chicago Blackhawks,2013/10/29  vs. OTT,OTT,1,52,48,4,-6,9,1,-1,44,42,2,-7,7,2,-2
Dallas Stars,2013/11/09  vs. CHI,CHI,1,52,44,8,-2,3,7,1,36,32,4,-7,7,4,-1
Anaheim Ducks,2013/12/29  vs. SJS,SJS,1,68,48,20,-5,0,25,-4,39,35,4,-3,0,7,-2
Washington Capitals,2013/10/24  vs. EDM,EDM,1,37,42,-5,1,-6,0,-1,31,33,-2,2,-4,0,2
Detroit Red Wings,2013/12/28  vs. FLA,FLA,1,36,45,-9,-6,-3,0,-8,26,28,-2,-6,4,0,-6
Nashville Predators,2014/01/16  vs. PHI,PHI,1,43,43,0,-5,11,-6,-5,32,26,6,-4,13,-3,1
Columbus Blue Jackets,2014/01/04  vs. STL,STL,1,38,60,-22,-3,-16,-3,-15,30,48,-18,-1,-14,-3,-12
New Jersey Devils,2013/12/28  vs. NYI,NYI,1,47,50,-3,7,-10,0,2,32,32,0,5,-5,0,2
New York Rangers,2014/03/14  vs. WPG,WPG,1,30,47,-17,-3,-10,-4,-8,19,32,-13,-5,-5,-3,-9
St. Louis Blues,2014/01/04  vs. CBJ,CBJ,1,60,38,22,3,3,16,15,48,30,18,1,3,14,12
Los Angeles Kings,2014/02/06  vs. CBJ,CBJ,1,30,30,0,0,0,0,0,19,23,-4,0,0,-4,-4
Ottawa Senators,2013/11/05  vs. CBJ,CBJ,1,42,41,1,5,-4,0,8,31,34,-3,2,-5,0,4
Tampa Bay Lightning,2014/04/01  vs. MTL,MTL,1,40,35,5,11,-1,-5,6,29,31,-2,5,-1,-6,-1
Detroit Red Wings,2014/02/02  vs. WSH,WSH,1,50,36,14,5,0,9,11,34,28,6,2,0,4,6
Anaheim Ducks,2014/01/03  vs. EDM,EDM,1,40,27,13,-2,12,3,11,32,20,12,-3,14,1,7
Calgary Flames,2013/10/04  vs. CBJ,CBJ,1,38,55,-17,-9,-8,0,-12,30,36,-6,-3,-3,0,-5
Columbus Blue Jackets,2013/11/29  vs. EDM,EDM,1,29,27,2,3,-1,0,9,16,22,-6,0,-6,0,0
Tampa Bay Lightning,2013/10/12  vs. PIT,PIT,1,26,37,-11,-3,-7,-1,-9,18,30,-12,-7,-4,-1,-10
Boston Bruins,2013/12/08  vs. TOR,TOR,1,57,56,1,-3,8,-4,3,44,41,3,0,7,-4,2
Winnipeg Jets,2013/12/05  vs. FLA,FLA,1,48,42,6,-3,3,6,3,38,30,8,-1,4,5,7
Vancouver Canucks,2014/01/21  vs. EDM,EDM,1,46,39,7,-3,10,0,15,34,28,6,-1,7,0,11
Toronto Maple Leafs,2013/10/10  vs. NSH,NSH,1,34,43,-9,-1,-8,0,0,26,33,-7,-3,-4,0,-3
Edmonton Oilers,2014/01/24  vs. PHX,PHX,1,50,47,3,-2,0,5,-1,40,33,7,1,0,6,1
Detroit Red Wings,2013/10/14  vs. BOS,BOS,1,39,47,-8,-6,-2,0,-5,35,32,3,1,2,0,2
Columbus Blue Jackets,2014/02/03  vs. ANA,ANA,1,41,60,-19,-4,-15,0,-11,30,43,-13,-6,-7,0,-9
Colorado Avalanche,2014/04/05  vs. STL,STL,1,36,38,-2,3,-5,0,1,29,27,2,0,2,0,-3
Minnesota Wild,2013/12/08  vs. SJS,SJS,1,30,47,-17,-11,-6,0,-18,19,34,-15,-11,-4,0,-18
Edmonton Oilers,2013/12/05  vs. COL,COL,1,28,47,-19,-4,-15,0,-11,23,36,-13,-2,-11,0,-6
Detroit Red Wings,2013/11/12  vs. WPG,WPG,1,48,31,17,18,0,-1,17,43,24,19,22,0,-3,19
Edmonton Oilers,2013/12/17  vs. LAK,LAK,1,42,63,-21,-9,0,-12,-8,31,57,-26,-9,0,-17,-11
Colorado Avalanche,2013/12/10  vs. PHX,PHX,1,40,46,-6,-5,0,-1,-11,33,34,-1,0,0,-1,-5
St. Louis Blues,2014/03/06  vs. NSH,NSH,1,27,31,-4,-9,5,0,-5,25,22,3,-4,7,0,-1
Chicago Blackhawks,2013/12/08  vs. FLA,FLA,1,41,47,-6,1,-7,0,6,32,33,-1,0,-1,0,5
Dallas Stars,2013/11/14  vs. CGY,CGY,1,59,43,16,7,9,0,12,41,31,10,5,5,0,10
Washington Capitals,2014/01/10  vs. TOR,TOR,1,50,50,0,2,1,-3,3,36,36,0,-1,4,-3,0
Toronto Maple Leafs,2013/12/23  vs. NYR,NYR,1,30,44,-14,-13,0,-1,-13,24,36,-12,-10,0,-2,-10
Ottawa Senators,2013/12/03  vs. FLA,FLA,1,49,42,7,5,-2,4,10,39,33,6,4,-1,3,8
Florida Panthers,2014/04/01  vs. NYI,NYI,1,41,57,-16,-7,0,-9,-6,24,40,-16,-8,0,-8,-8
Nashville Predators,2013/11/28  vs. EDM,EDM,1,41,43,-2,-11,0,9,-11,33,30,3,-7,0,10,-7
Minnesota Wild,2014/02/27  vs. EDM,EDM,1,37,33,4,0,4,0,6,26,22,4,0,4,0,6
Montreal Canadiens,2013/12/07  vs. BUF,BUF,1,39,46,-7,0,-7,0,-3,27,30,-3,-2,-1,0,-3
Ottawa Senators,2014/04/10  vs. NJD,NJD,1,47,46,1,-5,6,0,1,32,35,-3,-6,3,0,-3
Colorado Avalanche,2014/04/03  vs. NYR,NYR,1,34,26,8,-1,0,9,-3,29,24,5,-1,0,6,-3
Ottawa Senators,2013/12/05  vs. TBL,TBL,1,47,31,16,5,0,11,8,36,27,9,4,0,5,6
Toronto Maple Leafs,2013/10/17  vs. CAR,CAR,1,32,51,-19,-7,-13,1,-9,26,41,-15,-6,-9,0,-9
Los Angeles Kings,2013/10/19  vs. DAL,DAL,1,55,35,20,14,3,3,17,39,31,8,8,-2,2,9
Phoenix Coyotes,2013/10/19  vs. DET,DET,1,47,43,4,6,1,-3,5,32,37,-5,5,-1,-9,3
Florida Panthers,2013/11/05  vs. EDM,EDM,1,40,33,7,7,-1,1,6,28,23,5,1,0,4,0
Boston Bruins,2013/10/31  vs. ANA,ANA,1,39,25,14,6,0,8,7,27,21,6,3,0,3,4
New York Rangers,2013/12/27  vs. WSH,WSH,1,51,33,18,19,0,-1,19,39,23,16,17,0,-1,18
Colorado Avalanche,2014/02/03  vs. NJD,NJD,1,25,36,-11,1,0,-12,-9,22,32,-10,1,0,-11,-6
Carolina Hurricanes,2013/10/06  vs. PHI,PHI,1,49,36,13,8,5,0,15,38,27,11,4,7,0,12
Florida Panthers,2014/04/04  vs. CGY,CGY,1,50,25,25,17,0,8,21,34,17,17,11,0,6,15
Ottawa Senators,2013/12/12  vs. BUF,BUF,1,53,46,7,10,-3,0,1,39,38,1,11,-10,0,-1
Vancouver Canucks,2013/11/09  vs. LAK,LAK,1,42,49,-7,-1,0,-6,0,34,36,-2,2,0,-4,3
Ottawa Senators,2014/04/13  vs. PIT,PIT,1,34,32,2,5,0,-3,2,26,28,-2,1,0,-3,-2
Phoenix Coyotes,2013/11/25  vs. NSH,NSH,1,50,44,6,-1,0,7,-4,37,35,2,-1,0,3,-3
New Jersey Devils,2014/03/11  vs. PHI,PHI,1,38,40,-2,2,-4,0,4,26,30,-4,-2,-2,0,2
Nashville Predators,2013/11/12  vs. NYI,NYI,1,52,55,-3,-12,0,9,-16,38,34,4,-4,0,8,-8
Winnipeg Jets,2014/02/06  vs. WSH,WSH,1,49,44,5,-3,11,-3,4,38,33,5,-3,8,0,5
Anaheim Ducks,2014/01/25  vs. LAK,LAK,1,27,45,-18,-3,-15,0,-5,26,32,-6,-2,-4,0,-3
New York Rangers,2013/11/29  vs. BOS,BOS,1,27,48,-21,-8,-11,-2,-19,21,35,-14,-4,-7,-3,-12
Buffalo Sabres,2014/03/29  vs. TBL,TBL,1,43,48,-5,1,-6,0,-3,32,35,-3,1,-4,0,-1
Los Angeles Kings,2013/10/30  vs. SJS,SJS,1,43,25,18,11,0,7,14,29,20,9,7,0,2,8
Nashville Predators,2013/11/15  vs. PIT,PIT,1,32,42,-10,0,-1,-9,-2,23,31,-8,0,1,-9,-2
New York Rangers,2013/11/16  vs. MTL,MTL,1,60,48,12,19,-7,0,14,48,30,18,14,4,0,14
New Jersey Devils,2013/12/10  vs. CBJ,CBJ,1,45,24,21,3,4,14,10,37,22,15,0,3,12,5
Columbus Blue Jackets,2013/10/05  vs. NYI,NYI,1,49,42,7,-1,0,8,-5,30,31,-1,-3,0,2,-7
Buffalo Sabres,2014/03/06  vs. TBL,TBL,1,35,76,-41,-8,-33,0,-21,30,56,-26,-8,-18,0,-11
Toronto Maple Leafs,2014/02/08  vs. VAN,VAN,1,53,40,13,-7,-1,21,3,34,31,3,-7,1,9,-4
Dallas Stars,2013/10/24  vs. CGY,CGY,1,54,53,1,10,-9,0,8,45,36,9,9,0,0,7
Columbus Blue Jackets,2013/12/29  vs. PIT,PIT,1,57,26,31,21,2,8,26,38,22,16,11,1,4,15
Ottawa Senators,2014/01/08  vs. COL,COL,1,53,52,1,-2,-12,15,10,38,40,-2,-1,-7,6,3
Ottawa Senators,2013/10/19  vs. EDM,EDM,1,47,17,30,6,0,24,11,35,17,18,5,0,13,9
Vancouver Canucks,2013/12/19  vs. DAL,DAL,1,40,46,-6,-7,0,1,-2,29,31,-2,-5,0,3,2
Florida Panthers,2013/12/15  vs. MTL,MTL,1,48,35,13,17,-4,0,18,30,20,10,9,1,0,11
San Jose Sharks,2013/11/15  vs. EDM,EDM,1,41,51,-10,1,-11,0,-1,34,36,-2,4,-6,0,3
Winnipeg Jets,2014/03/22  vs. CAR,CAR,1,52,61,-9,-11,1,1,-13,33,44,-11,-8,1,-4,-12
Chicago Blackhawks,2013/12/14  vs. TOR,TOR,1,58,46,12,0,0,12,7,35,38,-3,0,0,-3,4
Calgary Flames,2014/03/24  vs. SJS,SJS,1,32,56,-24,-26,0,2,-24,25,42,-17,-18,0,1,-17
Chicago Blackhawks,2014/01/28  vs. CGY,CGY,1,65,36,29,26,0,3,28,42,28,14,13,0,1,14
Montreal Canadiens,2014/03/06  vs. PHX,PHX,1,41,34,7,-6,0,13,-3,28,25,3,-5,0,8,-4
New York Islanders,2013/12/17  vs. TBL,TBL,1,44,66,-22,-5,-17,0,-10,35,42,-7,0,-7,0,-2
Ottawa Senators,2014/01/02  vs. WPG,WPG,1,51,55,-4,-4,0,0,-9,36,43,-7,-5,-2,0,-11
Chicago Blackhawks,2013/11/02  vs. WPG,WPG,1,48,55,-7,-4,-2,-1,-2,31,39,-8,-1,-5,-2,-2
San Jose Sharks,2013/12/21  vs. DAL,DAL,1,45,60,-15,1,0,-16,-17,35,50,-15,-2,0,-13,-15
Buffalo Sabres,2013/10/31  vs. NYR,NYR,1,40,62,-22,-8,0,-14,-19,34,46,-12,-5,0,-7,-13
Pittsburgh Penguins,2013/11/25  vs. BOS,BOS,1,46,44,2,-7,0,9,-1,36,34,2,-8,0,10,0
New York Rangers,2014/03/02  vs. BOS,BOS,1,60,58,2,0,4,-2,4,46,43,3,0,8,-5,11
Vancouver Canucks,2013/11/05  vs. PHX,PHX,1,47,49,-2,-3,1,0,-2,35,36,-1,-6,2,3,-1
Detroit Red Wings,2013/11/19  vs. NSH,NSH,1,35,27,8,1,0,7,1,25,22,3,-1,0,4,-1
Toronto Maple Leafs,2014/03/29  vs. DET,DET,1,39,42,-3,2,-2,-3,-2,29,29,0,3,-1,-2,1
Minnesota Wild,2013/11/27  vs. PHX,PHX,1,48,29,19,-2,0,21,5,34,25,9,-3,0,12,0
Tampa Bay Lightning,2013/10/15  vs. LAK,LAK,1,36,44,-8,1,-9,0,1,27,35,-8,1,-9,0,2
Chicago Blackhawks,2014/01/03  vs. NJD,NJD,1,31,36,-5,-2,-3,0,-2,25,28,-3,-2,-1,0,-2
New York Islanders,2014/02/04  vs. WSH,WSH,1,36,36,0,-4,4,0,-4,20,24,-4,-6,2,0,-6
Edmonton Oilers,2013/10/27  vs. LAK,LAK,1,21,59,-38,-33,-5,0,-38,16,49,-33,-29,-4,0,-33
Ottawa Senators,2014/01/14  vs. MIN,MIN,1,39,44,-5,12,-17,0,7,32,32,0,10,-10,0,9
Nashville Predators,2013/12/12  vs. DAL,DAL,1,38,50,-12,-3,-8,-1,-6,31,35,-4,-2,-1,-1,-3
Calgary Flames,2013/11/18  vs. WPG,WPG,1,38,66,-28,-23,-5,0,-28,25,39,-14,-15,1,0,-16
Pittsburgh Penguins,2013/11/27  vs. TOR,TOR,1,67,38,29,21,2,6,28,47,27,20,20,0,0,18
Edmonton Oilers,2013/10/01  vs. WPG,WPG,1,48,39,9,4,-2,7,-2,30,31,-1,2,-5,2,-3
San Jose Sharks,2013/10/19  vs. CGY,CGY,1,44,28,16,0,16,0,-1,25,17,8,0,8,0,0
Columbus Blue Jackets,2014/02/27  vs. NJD,NJD,1,37,42,-5,-2,0,-3,-2,28,38,-10,-3,0,-7,-3
Colorado Avalanche,2013/11/21  vs. PHX,PHX,1,36,65,-29,-17,-14,2,-20,25,54,-29,-14,-17,2,-19
Columbus Blue Jackets,2013/12/21  vs. PHI,PHI,1,33,26,7,3,4,0,7,27,21,6,1,5,0,3
Winnipeg Jets,2014/02/04  vs. CAR,CAR,1,46,50,-4,0,-4,0,-3,39,42,-3,0,-3,0,-2
Washington Capitals,2013/12/17  vs. PHI,PHI,1,39,48,-9,-2,-3,-4,-5,26,29,-3,0,1,-4,1
Anaheim Ducks,2013/12/06  vs. CHI,CHI,1,35,45,-10,-13,3,0,-10,27,30,-3,-6,3,0,-3
Montreal Canadiens,2013/11/10  vs. NYI,NYI,1,46,48,-2,1,-3,0,0,34,29,5,2,3,0,1
New Jersey Devils,2014/04/11  vs. NYI,NYI,1,38,37,1,8,-9,2,1,32,31,1,8,-9,2,1
Buffalo Sabres,2014/01/28  vs. WSH,WSH,1,47,47,0,-3,0,3,-10,35,37,-2,-5,0,3,-12
Pittsburgh Penguins,2013/12/16  vs. TOR,TOR,1,40,38,2,-1,3,0,3,33,25,8,-1,9,0,8
Winnipeg Jets,2013/10/24  vs. NSH,NSH,1,50,41,9,12,0,-3,6,36,31,5,8,0,-3,3
Florida Panthers,2014/03/11  vs. PHX,PHX,1,45,35,10,-3,0,13,0,39,31,8,-2,0,10,0
Washington Capitals,2014/02/08  vs. NJD,NJD,1,41,51,-10,-5,-5,0,-5,27,33,-6,-4,-2,0,-4
San Jose Sharks,2014/01/02  vs. EDM,EDM,1,55,34,21,9,12,0,11,44,26,18,7,11,0,9
Boston Bruins,2014/04/03  vs. TOR,TOR,1,71,30,41,18,0,23,16,51,25,26,14,0,12,12
Phoenix Coyotes,2013/10/08  vs. NYI,NYI,1,54,39,15,-1,0,16,7,48,30,18,-1,0,19,7
Tampa Bay Lightning,2013/11/25  vs. NYR,NYR,1,33,54,-21,2,-23,0,1,27,33,-6,2,-8,0,1
New York Islanders,2013/11/10  vs. MTL,MTL,1,48,46,2,-1,0,3,0,29,34,-5,-2,0,-3,-1
Pittsburgh Penguins,2013/11/02  vs. CBJ,CBJ,1,27,27,0,6,-6,0,7,22,17,5,7,-2,0,9
Pittsburgh Penguins,2014/02/05  vs. BUF,BUF,1,48,50,-2,0,-5,3,3,35,33,2,1,-1,2,4
Los Angeles Kings,2013/10/13  vs. FLA,FLA,1,51,28,23,7,16,0,12,36,24,12,3,9,0,8
Detroit Red Wings,2014/03/29  vs. TOR,TOR,1,42,39,3,-2,3,2,2,29,29,0,-3,2,1,-1
Edmonton Oilers,2014/03/14  vs. DET,DET,1,36,46,-10,2,0,-12,-9,24,35,-11,1,0,-12,-11
Winnipeg Jets,2014/01/05  vs. PIT,PIT,1,49,46,3,13,-11,1,9,39,38,1,9,-9,1,6
Winnipeg Jets,2013/12/22  vs. VAN,VAN,1,46,44,2,10,0,-8,6,24,27,-3,7,0,-10,2
Philadelphia Flyers,2013/11/05  vs. CAR,CAR,1,52,55,-3,-1,-2,0,-1,33,42,-9,-7,-2,0,-7
Calgary Flames,2013/12/17  vs. BOS,BOS,1,29,42,-13,-2,0,-11,-15,21,35,-14,-2,0,-12,-14
Columbus Blue Jackets,2014/02/06  vs. LAK,LAK,1,30,30,0,0,0,0,0,23,19,4,0,4,0,4
Buffalo Sabres,2014/03/25  vs. MTL,MTL,1,29,45,-16,-14,0,-2,-14,19,34,-15,-14,0,-1,-14
Edmonton Oilers,2013/10/07  vs. NJD,NJD,1,36,36,0,1,4,-5,-1,24,27,-3,1,3,-7,-3
Edmonton Oilers,2014/03/04  vs. OTT,OTT,1,44,70,-26,-9,-11,-6,-11,35,50,-15,-4,-7,-4,-5
Ottawa Senators,2014/03/20  vs. TBL,TBL,1,48,20,28,3,0,25,16,33,15,18,4,0,14,10
Minnesota Wild,2013/10/14  vs. BUF,BUF,1,29,35,-6,1,-7,0,0,24,27,-3,1,-4,0,-1
Montreal Canadiens,2014/01/11  vs. CHI,CHI,1,49,41,8,3,5,0,-1,36,26,10,5,5,0,3
Chicago Blackhawks,2013/10/26  vs. MIN,MIN,1,47,24,23,3,0,20,8,35,19,16,2,0,14,5
Toronto Maple Leafs,2013/11/29  vs. BUF,BUF,1,41,50,-9,-8,-1,0,-9,31,33,-2,-4,2,0,-2
Dallas Stars,2013/12/29  vs. STL,STL,1,54,37,17,3,0,14,19,33,27,6,1,0,5,8
Edmonton Oilers,2013/12/10  vs. CAR,CAR,1,45,49,-4,2,-6,0,7,33,33,0,1,-1,0,9
Chicago Blackhawks,2013/11/25  vs. EDM,EDM,1,35,37,-2,-2,0,0,-1,29,27,2,-2,4,0,-1
St. Louis Blues,2014/01/23  vs. NYR,NYR,1,45,47,-2,-9,7,0,-5,30,36,-6,-4,-2,0,-7
Detroit Red Wings,2013/11/27  vs. BOS,BOS,1,30,29,1,2,-1,0,-1,26,19,7,3,4,0,1
Montreal Canadiens,2013/10/17  vs. CBJ,CBJ,1,44,41,3,-1,4,0,-5,33,28,5,1,4,0,-3
Winnipeg Jets,2014/01/31  vs. VAN,VAN,1,48,51,-3,1,-4,0,5,34,35,-1,0,-1,0,6
Phoenix Coyotes,2014/03/17  vs. LAK,LAK,1,27,44,-17,-8,-5,-4,-12,23,35,-12,-10,1,-3,-13
Boston Bruins,2013/11/30  vs. CBJ,CBJ,1,51,29,22,3,19,0,10,38,16,22,2,20,0,9
Anaheim Ducks,2013/12/11  vs. MIN,MIN,1,42,34,8,0,8,0,7,37,29,8,-2,10,0,5
Winnipeg Jets,2013/11/29  vs. PHI,PHI,1,38,48,-10,-1,0,-9,-10,26,33,-7,-1,0,-6,-10
New York Rangers,2013/11/10  vs. FLA,FLA,1,47,45,2,-3,2,3,6,35,35,0,-2,0,2,3
Buffalo Sabres,2013/11/02  vs. ANA,ANA,1,33,49,-16,-11,1,-6,-11,21,38,-17,-9,0,-8,-10
Washington Capitals,2014/01/31  vs. DET,DET,1,37,45,-8,0,-3,-5,-4,27,37,-10,-1,-3,-6,-4
Detroit Red Wings,2014/01/11  vs. LAK,LAK,1,30,58,-28,-20,-7,-1,-21,26,52,-26,-20,-6,0,-20
Tampa Bay Lightning,2013/11/14  vs. ANA,ANA,1,40,31,9,9,0,0,8,31,22,9,5,4,0,6
Winnipeg Jets,2013/12/27  vs. MIN,MIN,1,54,41,13,11,3,-1,12,36,30,6,7,4,-5,4
Boston Bruins,2013/11/14  vs. CBJ,CBJ,1,53,42,11,9,-4,6,11,35,34,1,-1,-3,5,1
Detroit Red Wings,2014/03/04  vs. NJD,NJD,1,23,36,-13,-14,3,-2,-10,19,31,-12,-14,4,-2,-9
Minnesota Wild,2013/11/15  vs. FLA,FLA,1,26,40,-14,3,-17,0,3,19,30,-11,1,-12,0,0
Philadelphia Flyers,2014/03/08  vs. TOR,TOR,1,68,52,16,5,0,11,4,44,42,2,2,0,0,0
Philadelphia Flyers,2013/10/17  vs. PIT,PIT,1,48,47,1,-2,0,3,-8,31,35,-4,-6,0,2,-12
Washington Capitals,2013/10/12  vs. COL,COL,1,62,34,28,4,0,24,-1,45,27,18,3,0,15,1
Winnipeg Jets,2014/01/11  vs. CBJ,CBJ,1,39,40,-1,2,-6,3,-7,29,33,-4,4,-5,-3,-4
Calgary Flames,2013/12/19  vs. DET,DET,1,25,49,-24,-22,0,-2,-24,19,37,-18,-15,0,-3,-18
Pittsburgh Penguins,2013/10/03  vs. NJD,NJD,1,35,54,-19,2,-21,0,1,26,34,-8,5,-13,0,5
Phoenix Coyotes,2013/10/05  vs. SJS,SJS,1,36,57,-21,0,0,-21,2,24,46,-22,0,0,-22,3
Ottawa Senators,2014/03/16  vs. COL,COL,1,64,36,28,13,0,15,15,46,28,18,10,0,8,12
Tampa Bay Lightning,2013/11/27  vs. PHI,PHI,1,49,34,15,15,0,0,15,40,25,15,12,3,0,13
Los Angeles Kings,2014/02/01  vs. PHI,PHI,1,58,23,35,17,0,18,28,43,17,26,10,0,16,19
Philadelphia Flyers,2014/04/08  vs. FLA,FLA,1,36,55,-19,-6,-13,0,-13,31,44,-13,-2,-11,0,-9
Winnipeg Jets,2014/04/01  vs. PHX,PHX,1,39,54,-15,-18,3,0,-15,27,42,-15,-15,0,0,-15
Nashville Predators,2014/01/20  vs. DAL,DAL,1,36,59,-23,-4,-17,-2,-9,24,47,-23,-3,-17,-3,-7
Ottawa Senators,2014/01/23  vs. TBL,TBL,1,65,39,26,3,0,23,7,43,36,7,-7,0,14,-7
Anaheim Ducks,2014/03/15  vs. LAK,LAK,1,33,54,-21,-11,-10,0,-14,29,40,-11,-4,-7,0,-7
Edmonton Oilers,2013/11/28  vs. NSH,NSH,1,43,41,2,11,-9,0,11,30,33,-3,7,-10,0,7
Minnesota Wild,2013/10/05  vs. ANA,ANA,1,51,26,25,2,0,23,5,36,22,14,0,0,14,1
Carolina Hurricanes,2014/02/07  vs. FLA,FLA,1,52,67,-15,2,-17,0,4,40,44,-4,2,-6,0,5
Dallas Stars,2013/11/23  vs. STL,STL,1,52,38,14,2,0,12,6,40,31,9,1,0,8,4
Minnesota Wild,2013/11/30  vs. COL,COL,1,50,45,5,-4,0,9,2,35,29,6,-2,0,8,4
Phoenix Coyotes,2014/01/28  vs. LAK,LAK,1,51,53,-2,8,-10,0,0,36,45,-9,4,-13,0,-3
Carolina Hurricanes,2013/12/21  vs. TBL,TBL,1,44,62,-18,-20,2,0,-19,33,49,-16,-20,4,0,-20
Washington Capitals,2014/02/02  vs. DET,DET,1,36,50,-14,-5,-9,0,-11,28,34,-6,-2,-4,0,-6
Pittsburgh Penguins,2013/10/17  vs. PHI,PHI,1,47,48,-1,2,-3,0,8,35,31,4,6,-2,0,12
Colorado Avalanche,2013/10/17  vs. DET,DET,1,43,39,4,-4,0,8,0,30,27,3,-3,0,6,-2
Edmonton Oilers,2013/10/26  vs. PHX,PHX,1,39,34,5,1,2,2,7,31,26,5,2,3,0,6
New Jersey Devils,2013/12/21  vs. WSH,WSH,1,66,32,34,10,13,11,26,45,25,20,9,5,6,15
Phoenix Coyotes,2013/11/05  vs. VAN,VAN,1,49,47,2,3,0,-1,2,36,35,1,6,-3,-2,1
San Jose Sharks,2014/01/09  vs. DET,DET,1,44,43,1,1,0,0,2,36,28,8,1,7,0,7
Philadelphia Flyers,2013/11/12  vs. OTT,OTT,1,47,45,2,5,-3,0,7,35,33,2,2,0,0,5
Ottawa Senators,2013/12/10  vs. BUF,BUF,1,54,39,15,10,5,0,15,41,33,8,5,3,0,8
Minnesota Wild,2014/01/12  vs. NSH,NSH,1,36,55,-19,-2,-17,0,1,31,35,-4,0,-4,0,3
Pittsburgh Penguins,2013/11/15  vs. NSH,NSH,1,42,32,10,0,9,1,2,31,23,8,0,9,-1,2
New York Rangers,2013/10/31  vs. BUF,BUF,1,62,40,22,8,14,0,19,46,34,12,5,7,0,13
New York Rangers,2014/03/07  vs. CAR,CAR,1,53,36,17,10,-1,8,17,40,27,13,10,-1,4,13
New York Islanders,2013/12/10  vs. SJS,SJS,1,50,70,-20,-16,0,-4,-18,30,52,-22,-15,0,-7,-15
Detroit Red Wings,2014/04/11  vs. CAR,CAR,1,37,25,12,5,0,7,10,31,18,13,4,0,9,9
Pittsburgh Penguins,2014/02/27  vs. MTL,MTL,1,32,36,-4,-5,0,1,-4,23,28,-5,-5,1,-1,-5
Philadelphia Flyers,2014/01/23  vs. CBJ,CBJ,1,26,39,-13,-5,-4,-4,-9,19,30,-11,-3,-2,-6,-6
Tampa Bay Lightning,2014/03/01  vs. DAL,DAL,1,36,66,-30,1,-31,0,-4,28,45,-17,1,-18,0,0
New York Rangers,2014/02/04  vs. COL,COL,1,61,47,14,13,1,0,17,48,32,16,12,4,0,16
Ottawa Senators,2014/01/25  vs. CAR,CAR,1,50,35,15,5,0,10,10,37,30,7,4,0,3,8
Philadelphia Flyers,2014/03/11  vs. NJD,NJD,1,40,38,2,-2,0,4,-4,30,26,4,2,0,2,-2
Florida Panthers,2013/11/30  vs. PIT,PIT,1,61,45,16,11,0,5,9,45,33,12,8,0,4,7
Montreal Canadiens,2014/04/09  vs. CHI,CHI,1,43,50,-7,-3,-4,0,-3,36,31,5,7,-2,0,7
Anaheim Ducks,2013/11/15  vs. CAR,CAR,1,39,41,-2,-3,-3,4,-6,36,28,8,7,-2,3,5
Anaheim Ducks,2013/11/12  vs. FLA,FLA,1,36,37,-1,-8,1,6,-10,32,27,5,-7,5,7,-7
Toronto Maple Leafs,2013/10/30  vs. CGY,CGY,1,40,58,-18,-6,-12,0,-13,27,43,-16,-6,-10,0,-11
Vancouver Canucks,2014/02/28  vs. MIN,MIN,1,59,28,31,31,0,0,31,39,23,16,15,1,0,16
Montreal Canadiens,2013/12/12  vs. PHI,PHI,1,39,48,-9,-11,0,2,-12,26,30,-4,-4,0,0,-2
St. Louis Blues,2014/04/10  vs. MIN,MIN,1,47,15,32,2,0,30,15,41,14,27,2,0,25,12
San Jose Sharks,2014/01/18  vs. TBL,TBL,1,50,50,0,-6,6,0,-1,39,39,0,-4,6,-2,2
Nashville Predators,2014/01/11  vs. OTT,OTT,1,44,49,-5,-1,0,-4,-5,35,37,-2,1,0,-3,-2
Los Angeles Kings,2013/10/24  vs. PHX,PHX,1,37,37,0,-2,2,0,-2,32,28,4,-1,5,0,-1
New Jersey Devils,2014/01/16  vs. COL,COL,1,40,47,-7,3,0,-10,-5,28,36,-8,2,0,-10,-6
Florida Panthers,2013/12/07  vs. DET,DET,1,51,33,18,9,-1,10,19,42,27,15,8,0,7,15
Colorado Avalanche,2014/02/06  vs. PHI,PHI,1,52,43,9,-2,0,11,0,32,35,-3,-7,0,4,-6
Detroit Red Wings,2013/10/17  vs. COL,COL,1,39,43,-4,4,-8,0,0,27,30,-3,3,-6,0,2
Phoenix Coyotes,2013/12/10  vs. COL,COL,1,46,40,6,5,1,0,11,34,33,1,0,1,0,5
Dallas Stars,2014/04/08  vs. NSH,NSH,1,49,59,-10,-10,0,0,-13,35,41,-6,-2,-4,0,-7
San Jose Sharks,2013/10/26  vs. MTL,MTL,1,58,33,25,7,18,0,11,44,24,20,7,13,0,7
Dallas Stars,2014/02/27  vs. CAR,CAR,1,34,32,2,0,2,0,0,24,24,0,-1,1,0,-1
Vancouver Canucks,2014/01/23  vs. NSH,NSH,1,44,35,9,0,7,2,4,31,26,5,1,2,2,1
Winnipeg Jets,2013/10/01  vs. EDM,EDM,1,39,48,-9,-4,-7,2,2,31,30,1,-2,-2,5,3
Phoenix Coyotes,2013/12/14  vs. CAR,CAR,1,52,52,0,4,1,-5,5,39,35,4,5,2,-3,7
San Jose Sharks,2014/01/11  vs. BOS,BOS,1,56,48,8,2,0,6,2,41,30,11,9,0,2,9
St. Louis Blues,2014/02/08  vs. WPG,WPG,1,21,35,-14,-9,-5,0,-9,15,26,-11,-8,-3,0,-9
Calgary Flames,2014/01/09  vs. STL,STL,1,37,35,2,-2,0,4,-7,24,25,-1,0,0,-1,-4
Toronto Maple Leafs,2014/03/22  vs. MTL,MTL,1,59,55,4,3,0,1,5,40,45,-5,-1,0,-4,-4
Calgary Flames,2014/03/12  vs. ANA,ANA,1,31,40,-9,0,-9,0,1,23,27,-4,-2,-2,0,0
Chicago Blackhawks,2014/01/19  vs. BOS,BOS,1,48,49,-1,-2,4,-3,-1,37,36,1,2,3,-4,1
Florida Panthers,2013/12/29  vs. MTL,MTL,1,43,31,12,5,7,0,15,33,25,8,3,5,0,9
Carolina Hurricanes,2013/12/10  vs. EDM,EDM,1,49,45,4,-2,0,6,-7,33,33,0,-1,0,1,-9
New York Rangers,2013/10/10  vs. ANA,ANA,1,45,37,8,-2,0,10,-5,33,31,2,-2,0,4,-6
Dallas Stars,2013/10/11  vs. WPG,WPG,1,37,46,-9,6,-15,0,6,31,36,-5,4,-9,0,5
Detroit Red Wings,2014/04/02  vs. BOS,BOS,1,27,42,-15,-10,-4,-1,-15,24,33,-9,-6,-2,-1,-10
Chicago Blackhawks,2014/01/08  vs. NYR,NYR,1,45,36,9,-6,0,15,-5,36,27,9,0,0,9,-1
St. Louis Blues,2014/01/02  vs. LAK,LAK,1,29,49,-20,2,-22,0,-13,24,30,-6,1,-7,0,-9
Vancouver Canucks,2013/11/14  vs. SJS,SJS,1,60,47,13,5,8,0,11,44,29,15,6,9,0,14
Washington Capitals,2014/01/21  vs. OTT,OTT,1,34,44,-10,-8,0,-2,-2,28,34,-6,-4,0,-2,0
Washington Capitals,2014/01/25  vs. MTL,MTL,1,41,40,1,3,-2,0,7,28,24,4,2,2,0,5
Washington Capitals,2014/01/19  vs. NYR,NYR,1,47,35,12,0,0,12,0,32,26,6,0,0,6,1
Carolina Hurricanes,2014/01/22  vs. PHI,PHI,1,53,39,14,16,-2,0,13,39,31,8,11,-3,0,5
Buffalo Sabres,2014/01/02  vs. MIN,MIN,1,26,37,-11,-7,0,-4,-5,20,32,-12,-7,0,-5,-6
New York Rangers,2013/10/26  vs. DET,DET,1,37,32,5,-1,0,6,5,35,29,6,-1,0,7,5
Montreal Canadiens,2014/03/20  vs. CBJ,CBJ,1,37,45,-8,-4,-1,-3,-5,26,37,-11,-7,-1,-3,-10
Colorado Avalanche,2013/10/15  vs. DAL,DAL,1,38,41,-3,1,-6,2,-6,26,34,-8,-1,-7,0,-10
Ottawa Senators,2014/03/04  vs. EDM,EDM,1,70,44,26,9,6,11,11,50,35,15,4,4,7,5
Buffalo Sabres,2013/10/08  vs. TBL,TBL,1,33,46,-13,-7,-6,0,-10,25,35,-10,-5,-5,0,-7
Philadelphia Flyers,2014/01/11  vs. TBL,TBL,1,57,35,22,0,0,22,11,44,29,15,0,0,15,8
Florida Panthers,2014/01/16  vs. SJS,SJS,1,35,47,-12,-10,0,-2,-11,27,43,-16,-9,0,-7,-11
Nashville Predators,2014/02/06  vs. MIN,MIN,1,38,40,-2,-3,0,1,-2,30,26,4,6,0,-2,4
Ottawa Senators,2013/11/27  vs. WSH,WSH,1,41,40,1,-2,3,0,-3,34,32,2,2,1,-1,1
Boston Bruins,2014/01/09  vs. LAK,LAK,1,35,46,-11,0,0,-11,-3,29,38,-9,-3,0,-6,-6
Washington Capitals,2013/11/12  vs. CBJ,CBJ,1,45,44,1,1,-1,1,0,30,29,1,-1,0,2,-2
Washington Capitals,2014/01/30  vs. CBJ,CBJ,1,28,23,5,-1,0,6,-2,16,20,-4,-1,0,-3,-2
Carolina Hurricanes,2014/01/28  vs. MTL,MTL,1,57,37,20,5,0,15,3,36,28,8,4,0,4,2
Boston Bruins,2013/10/24  vs. SJS,SJS,1,37,66,-29,-32,3,0,-29,26,49,-23,-25,2,0,-23
Boston Bruins,2013/12/27  vs. OTT,OTT,1,58,52,6,-3,9,0,2,44,41,3,-4,7,0,0
Anaheim Ducks,2014/01/21  vs. WPG,WPG,1,74,37,37,11,1,25,25,45,34,11,2,1,8,11
New Jersey Devils,2013/11/15  vs. LAK,LAK,1,38,34,4,6,0,-2,6,31,23,8,10,0,-2,10
Vancouver Canucks,2013/11/28  vs. OTT,OTT,1,36,58,-22,-3,-16,-3,-5,27,41,-14,1,-12,-3,-1
Nashville Predators,2013/12/05  vs. CAR,CAR,1,24,43,-19,-5,1,-15,-18,20,24,-4,-1,1,-4,-4
Buffalo Sabres,2013/11/29  vs. TOR,TOR,1,50,41,9,8,0,1,9,33,31,2,4,0,-2,2
St. Louis Blues,2013/11/09  vs. PIT,PIT,1,46,28,18,19,-1,0,19,38,20,18,18,0,0,18
Boston Bruins,2014/04/13  vs. NJD,NJD,1,23,41,-18,-11,0,-7,-16,19,33,-14,-11,0,-3,-13
Phoenix Coyotes,2014/01/09  vs. MIN,MIN,1,61,38,23,20,0,3,20,43,26,17,19,0,-2,18
St. Louis Blues,2014/04/08  vs. WSH,WSH,1,53,20,33,10,0,23,15,35,14,21,6,0,15,9
Buffalo Sabres,2014/01/18  vs. CBJ,CBJ,1,29,56,-27,-14,-4,-9,-18,23,39,-16,-10,-4,-2,-13
Nashville Predators,2014/01/14  vs. CGY,CGY,1,44,40,4,8,-4,0,2,32,28,4,6,-2,0,2
St. Louis Blues,2014/03/22  vs. PHI,PHI,1,43,40,3,-3,7,-1,3,30,21,9,1,5,3,7
Tampa Bay Lightning,2014/03/19  vs. TOR,TOR,1,51,45,6,9,-3,0,16,39,35,4,7,-2,-1,11
Philadelphia Flyers,2013/12/30  vs. VAN,VAN,1,36,45,-9,-8,0,-1,-11,25,36,-11,-8,-2,-1,-13
Winnipeg Jets,2014/01/26  vs. CHI,CHI,1,41,52,-11,7,-1,-17,-13,33,42,-9,6,0,-15,-11
Boston Bruins,2014/01/30  vs. MTL,MTL,1,53,49,4,-7,0,11,12,38,37,1,-5,0,6,10
Pittsburgh Penguins,2014/03/28  vs. CBJ,CBJ,1,44,39,5,5,0,0,5,34,35,-1,-1,0,0,-1
Carolina Hurricanes,2014/04/13  vs. PHI,PHI,1,43,53,-10,-1,-9,0,-1,32,41,-9,-4,-5,0,-1
Vancouver Canucks,2014/01/15  vs. ANA,ANA,1,55,42,13,6,0,7,10,43,31,12,4,0,8,10
Washington Capitals,2013/12/27  vs. NYR,NYR,1,33,51,-18,-19,1,0,-19,23,39,-16,-17,1,0,-18
Winnipeg Jets,2014/03/06  vs. LAK,LAK,1,39,56,-17,-3,0,-14,-7,25,39,-14,-3,1,-12,-4
Edmonton Oilers,2014/01/10  vs. PIT,PIT,1,44,37,7,1,0,6,0,37,30,7,3,0,4,3
Nashville Predators,2014/01/24  vs. CGY,CGY,1,41,42,-1,4,-5,0,7,33,33,0,2,-2,0,7
Pittsburgh Penguins,2013/12/14  vs. DET,DET,1,24,37,-13,-3,-9,-1,-9,21,26,-5,-2,-2,-1,-7
New York Islanders,2014/04/05  vs. WSH,WSH,1,50,40,10,13,-3,0,13,38,28,10,11,-1,0,12
Ottawa Senators,2013/11/15  vs. BOS,BOS,1,45,52,-7,-3,8,-12,-11,34,41,-7,-3,7,-11,-11
Ottawa Senators,2014/01/16  vs. MTL,MTL,1,64,38,26,-3,-6,35,31,51,30,21,0,-6,27,25
Minnesota Wild,2014/03/09  vs. STL,STL,1,38,32,6,-6,0,12,3,31,24,7,-3,0,10,4
Nashville Predators,2014/04/05  vs. SJS,SJS,1,41,60,-19,-11,-8,0,-12,32,46,-14,-7,-7,0,-6
Winnipeg Jets,2014/03/01  vs. NSH,NSH,1,31,50,-19,-6,-13,0,-13,18,37,-19,-7,-12,0,-12
Tampa Bay Lightning,2013/10/08  vs. BUF,BUF,1,46,33,13,7,0,6,10,35,25,10,5,0,5,7
St. Louis Blues,2014/01/16  vs. LAK,LAK,1,32,29,3,-2,0,5,0,26,25,1,1,0,0,-1
Dallas Stars,2014/03/18  vs. PIT,PIT,1,48,42,6,0,0,6,1,35,34,1,-2,0,3,0
Buffalo Sabres,2013/12/12  vs. OTT,OTT,1,46,53,-7,-10,0,3,-1,38,39,-1,-11,0,10,1
Chicago Blackhawks,2013/12/27  vs. COL,COL,1,57,27,30,3,27,0,5,47,20,27,5,22,0,8
Chicago Blackhawks,2014/03/27  vs. BOS,BOS,1,41,38,3,-3,0,6,-4,33,29,4,-2,0,6,-2
Vancouver Canucks,2014/01/07  vs. PIT,PIT,1,49,49,0,-9,-1,10,0,39,38,1,-4,-1,6,4
Ottawa Senators,2014/03/24  vs. TBL,TBL,1,51,38,13,11,2,0,11,35,33,2,2,0,0,0
New York Rangers,2014/01/31  vs. NYI,NYI,1,59,48,11,11,0,0,5,45,33,12,12,0,0,7
Pittsburgh Penguins,2013/11/20  vs. WSH,WSH,1,50,29,21,6,15,0,14,40,16,24,6,18,0,12
Buffalo Sabres,2013/12/05  vs. NYR,NYR,1,50,51,-1,-2,0,1,-9,36,40,-4,-1,0,-3,-12
New York Rangers,2013/12/29  vs. TBL,TBL,1,37,58,-21,2,-21,-2,-3,28,45,-17,1,-17,-1,-2
New York Rangers,2014/01/04  vs. TOR,TOR,1,73,46,27,7,20,0,10,59,39,20,6,14,0,8
Dallas Stars,2014/01/18  vs. MIN,MIN,1,50,27,23,9,0,14,21,37,17,20,7,0,13,18
Los Angeles Kings,2014/03/06  vs. WPG,WPG,1,56,39,17,3,14,0,7,39,25,14,3,12,-1,4
Columbus Blue Jackets,2013/12/31  vs. COL,COL,1,50,34,16,-1,8,9,15,41,22,19,5,7,7,17
Boston Bruins,2013/12/19  vs. BUF,BUF,1,58,33,25,23,4,-2,27,38,20,18,15,4,-1,19
Dallas Stars,2014/01/30  vs. NJD,NJD,1,30,34,-4,0,0,-4,2,19,26,-7,-3,0,-4,0
Chicago Blackhawks,2013/11/16  vs. NSH,NSH,1,62,33,29,5,0,24,5,48,28,20,2,0,18,2
Buffalo Sabres,2013/12/27  vs. TOR,TOR,1,50,54,-4,-9,5,0,-7,41,41,0,-10,8,2,-8
Vancouver Canucks,2014/03/04  vs. PHX,PHX,1,53,48,5,3,0,2,-4,33,36,-3,1,0,-4,-9
Carolina Hurricanes,2013/10/17  vs. TOR,TOR,1,51,32,19,7,-1,13,9,41,26,15,6,0,9,9
Tampa Bay Lightning,2014/03/29  vs. BUF,BUF,1,48,43,5,-1,0,6,3,35,32,3,-1,0,4,1
Chicago Blackhawks,2013/10/19  vs. TOR,TOR,1,50,28,22,16,6,0,19,37,19,18,10,8,0,15
Nashville Predators,2013/11/10  vs. NJD,NJD,1,14,28,-14,-5,0,-9,-10,12,19,-7,-3,0,-4,-5
Nashville Predators,2013/12/19  vs. TBL,TBL,1,34,54,-20,-2,0,-18,-11,28,39,-11,0,0,-11,-7
Pittsburgh Penguins,2013/10/12  vs. TBL,TBL,1,37,26,11,3,1,7,9,30,18,12,7,1,4,10
Edmonton Oilers,2014/03/01  vs. CGY,CGY,1,54,47,7,3,0,4,10,32,33,-1,0,0,-1,4
New Jersey Devils,2014/03/18  vs. BOS,BOS,1,32,37,-5,-7,0,2,-7,20,28,-8,-7,0,-1,-7
Tampa Bay Lightning,2014/01/07  vs. WPG,WPG,1,47,28,19,7,10,2,12,33,16,17,7,11,-1,13
Los Angeles Kings,2014/04/12  vs. ANA,ANA,1,47,27,20,7,2,11,19,30,18,12,2,1,9,13
Tampa Bay Lightning,2013/10/27  vs. FLA,FLA,1,37,44,-7,0,-7,0,-1,30,33,-3,1,-4,0,2
Ottawa Senators,2014/04/05  vs. NYR,NYR,1,55,70,-15,-8,-7,0,-10,43,51,-8,-5,-3,0,-7
Los Angeles Kings,2013/12/19  vs. SJS,SJS,1,53,34,19,10,9,0,11,42,28,14,8,6,0,6
Florida Panthers,2013/12/08  vs. CHI,CHI,1,47,41,6,-1,0,7,-6,33,32,1,0,0,1,-5
Boston Bruins,2014/02/26  vs. BUF,BUF,1,43,20,23,8,3,12,21,29,18,11,3,1,7,11
Florida Panthers,2014/01/26  vs. DET,DET,1,29,39,-10,-6,-5,1,-16,28,28,0,-4,3,1,-6
Montreal Canadiens,2014/03/05  vs. ANA,ANA,1,48,39,9,11,-5,3,12,41,28,13,13,-2,2,13
Colorado Avalanche,2014/01/14  vs. CHI,CHI,1,29,56,-27,-10,-17,0,-17,22,42,-20,-9,-11,0,-14
Colorado Avalanche,2014/03/04  vs. CHI,CHI,1,27,51,-24,-13,-11,0,-18,17,36,-19,-10,-9,0,-14
Anaheim Ducks,2014/01/05  vs. VAN,VAN,1,74,32,42,-1,0,43,11,54,28,26,-3,0,29,7
New York Rangers,2013/12/02  vs. WPG,WPG,1,55,37,18,10,1,7,17,37,33,4,2,-2,4,3
Edmonton Oilers,2014/04/06  vs. ANA,ANA,1,37,54,-17,-1,-12,-4,-10,27,36,-9,0,-7,-2,-6
Ottawa Senators,2013/11/20  vs. MIN,MIN,1,54,35,19,7,9,3,16,37,29,8,3,7,-2,8
Florida Panthers,2013/11/25  vs. PHI,PHI,1,40,47,-7,-1,-6,0,1,31,32,-1,-1,0,0,2
St. Louis Blues,2013/11/29  vs. SJS,SJS,1,36,40,-4,0,0,-4,-2,21,26,-5,0,0,-5,-2
Carolina Hurricanes,2013/11/21  vs. DET,DET,1,35,54,-19,0,0,-19,-15,29,46,-17,0,0,-17,-14
Dallas Stars,2014/01/09  vs. NJD,NJD,1,38,41,-3,-5,0,2,-5,25,37,-12,-8,0,-4,-9
New York Islanders,2014/03/02  vs. FLA,FLA,1,34,44,-10,1,-6,-5,2,26,34,-8,1,-4,-5,2
Detroit Red Wings,2014/03/27  vs. MTL,MTL,1,42,32,10,2,0,8,4,33,26,7,3,0,4,6
Pittsburgh Penguins,2014/03/11  vs. WSH,WSH,1,43,44,-1,9,-10,0,8,35,36,-1,6,-7,0,7
Minnesota Wild,2014/03/31  vs. LAK,LAK,1,37,41,-4,6,0,-10,-1,30,32,-2,5,2,-9,-2
Chicago Blackhawks,2013/12/06  vs. ANA,ANA,1,45,35,10,13,0,-3,10,30,27,3,6,0,-3,3
Detroit Red Wings,2014/03/30  vs. TBL,TBL,1,38,33,5,6,0,-1,7,31,27,4,4,2,-2,4
New Jersey Devils,2014/01/18  vs. PHX,PHX,1,58,42,16,-3,0,19,9,37,34,3,-2,0,5,-1
Ottawa Senators,2013/11/17  vs. CBJ,CBJ,1,40,34,6,-5,0,11,-9,30,24,6,-1,0,7,-3
Colorado Avalanche,2014/04/11  vs. SJS,SJS,1,40,50,-10,2,0,-12,1,32,39,-7,2,0,-9,0
New York Islanders,2013/11/07  vs. CAR,CAR,1,48,45,3,8,0,-5,4,37,34,3,6,0,-3,4
Calgary Flames,2013/11/30  vs. LAK,LAK,1,28,42,-14,-9,-5,0,-9,22,26,-4,-2,-2,0,-2
Montreal Canadiens,2014/01/08  vs. PHI,PHI,1,39,44,-5,-4,0,-1,-9,23,34,-11,-5,0,-6,-9
Colorado Avalanche,2014/01/02  vs. PHI,PHI,1,51,37,14,1,13,0,7,38,27,11,2,9,0,6
Tampa Bay Lightning,2014/01/01  vs. VAN,VAN,1,52,49,3,10,-4,-3,8,37,40,-3,1,-1,-3,-1
Tampa Bay Lightning,2014/04/10  vs. PHI,PHI,1,37,49,-12,-4,-8,0,-15,28,36,-8,0,-8,0,-9
New York Rangers,2013/11/27  vs. FLA,FLA,1,31,51,-20,0,-20,0,-7,23,39,-16,-1,-15,0,-7
Columbus Blue Jackets,2014/04/04  vs. CHI,CHI,1,38,48,-10,-11,6,-5,-9,24,39,-15,-10,0,-5,-14
Phoenix Coyotes,2014/03/15  vs. CGY,CGY,1,33,37,-4,-7,3,0,-7,24,26,-2,-5,3,0,-8
Minnesota Wild,2013/12/29  vs. NYI,NYI,1,47,41,6,11,-8,3,11,39,32,7,11,-6,2,9
Carolina Hurricanes,2013/10/19  vs. NYI,NYI,1,42,36,6,6,0,0,6,30,23,7,5,2,0,6
Chicago Blackhawks,2014/02/03  vs. LAK,LAK,1,38,44,-6,-6,0,0,1,30,38,-8,-7,-1,0,-1
Detroit Red Wings,2013/11/16  vs. NYI,NYI,1,34,44,-10,-8,2,-4,-7,28,31,-3,-6,5,-2,-2
Winnipeg Jets,2013/10/22  vs. WSH,WSH,1,48,38,10,2,8,0,5,41,31,10,1,8,1,5
Calgary Flames,2013/12/10  vs. BOS,BOS,1,36,50,-14,-8,-8,2,0,26,33,-7,-8,1,0,1
New York Islanders,2014/01/04  vs. CAR,CAR,1,53,57,-4,7,0,-11,1,36,41,-5,3,0,-8,-2
Nashville Predators,2014/04/04  vs. ANA,ANA,1,37,43,-6,-4,-2,0,1,30,30,0,-4,4,0,0
Anaheim Ducks,2014/03/10  vs. TOR,TOR,1,58,34,24,0,0,24,2,41,22,19,0,0,19,-1
New York Rangers,2014/01/14  vs. TBL,TBL,1,52,44,8,-3,3,8,3,38,27,11,-1,5,7,10
Detroit Red Wings,2013/11/04  vs. WPG,WPG,1,33,54,-21,-6,-3,-12,-15,24,39,-15,-5,0,-10,-9
Winnipeg Jets,2013/11/10  vs. SJS,SJS,1,50,36,14,5,0,9,13,41,30,11,2,0,9,11
Buffalo Sabres,2014/04/01  vs. NJD,NJD,1,31,54,-23,-12,-1,-10,-21,22,35,-13,-3,-1,-9,-11
New Jersey Devils,2014/01/14  vs. MTL,MTL,1,42,37,5,2,2,1,3,32,29,3,1,-1,3,4
Tampa Bay Lightning,2014/04/08  vs. TOR,TOR,1,59,41,18,10,8,0,12,47,31,16,9,7,0,11
Winnipeg Jets,2013/10/13  vs. NJD,NJD,1,37,44,-7,-4,-3,0,-8,31,29,2,-2,4,0,-1
Minnesota Wild,2013/11/01  vs. MTL,MTL,1,45,56,-11,-4,-7,0,-10,31,36,-5,-3,-2,0,-6
Boston Bruins,2014/03/22  vs. PHX,PHX,1,49,39,10,5,-5,10,7,35,33,2,0,-4,6,1
New Jersey Devils,2014/01/24  vs. WSH,WSH,1,27,31,-4,-4,0,0,-1,25,25,0,-4,4,0,0
Tampa Bay Lightning,2014/01/05  vs. EDM,EDM,1,53,34,19,6,0,13,10,42,27,15,7,0,8,8
Anaheim Ducks,2013/11/02  vs. BUF,BUF,1,49,33,16,11,6,-1,11,38,21,17,9,8,0,10
Phoenix Coyotes,2014/01/07  vs. CGY,CGY,1,51,50,1,-5,6,0,-3,34,36,-2,-4,2,0,-3
Los Angeles Kings,2014/01/28  vs. PHX,PHX,1,53,51,2,-8,0,10,0,45,36,9,-4,0,13,3
Phoenix Coyotes,2013/10/22  vs. CGY,CGY,1,52,45,7,4,3,0,3,38,33,5,0,5,0,4
Detroit Red Wings,2013/10/15  vs. CBJ,CBJ,1,43,40,3,6,-3,0,0,35,32,3,8,-5,0,4
Columbus Blue Jackets,2013/12/27  vs. NJD,NJD,1,26,23,3,-2,5,0,3,22,19,3,-2,5,0,3
Florida Panthers,2013/12/20  vs. WPG,WPG,1,39,43,-4,-6,0,2,-6,26,38,-12,-5,0,-7,-5
Detroit Red Wings,2013/10/12  vs. PHI,PHI,1,27,44,-17,-2,-15,0,-8,20,35,-15,0,-15,0,-8
Nashville Predators,2013/10/24  vs. WPG,WPG,1,41,50,-9,-12,3,0,-6,31,36,-5,-8,3,0,-3
Anaheim Ducks,2013/11/20  vs. NJD,NJD,1,28,40,-12,-4,-9,1,-3,19,29,-10,-2,-7,-1,-3
New York Rangers,2014/01/10  vs. DAL,DAL,1,51,52,-1,2,1,-4,-2,38,42,-4,0,2,-6,-6
Winnipeg Jets,2013/11/25  vs. NJD,NJD,1,24,39,-15,0,-15,0,-6,19,28,-9,0,-9,0,-5
Nashville Predators,2013/10/12  vs. NYI,NYI,1,53,29,24,17,4,3,17,38,17,21,11,7,3,13
Dallas Stars,2014/04/03  vs. CAR,CAR,1,48,42,6,2,0,4,1,35,34,1,2,0,-1,1
Tampa Bay Lightning,2013/11/29  vs. PIT,PIT,1,41,43,-2,3,0,-5,-1,28,32,-4,0,0,-4,-5
Minnesota Wild,2014/03/26  vs. VAN,VAN,1,51,35,16,3,0,13,2,34,25,9,3,0,6,2
Florida Panthers,2014/03/22  vs. LAK,LAK,1,33,48,-15,-2,0,-13,-3,26,37,-11,-1,0,-10,-1
San Jose Sharks,2013/12/12  vs. MIN,MIN,1,32,45,-13,1,-14,0,5,28,33,-5,0,-5,0,3
Winnipeg Jets,2013/11/06  vs. CHI,CHI,1,36,44,-8,-4,0,-4,-2,28,32,-4,-7,0,3,-6
New Jersey Devils,2014/03/04  vs. DET,DET,1,36,23,13,14,2,-3,10,31,19,12,14,2,-4,9
Anaheim Ducks,2014/03/07  vs. PIT,PIT,1,51,37,14,10,4,0,11,36,19,17,13,4,0,16
Edmonton Oilers,2014/01/16  vs. MIN,MIN,1,35,49,-14,-2,0,-12,-14,25,39,-14,1,0,-15,-11
Los Angeles Kings,2014/03/17  vs. PHX,PHX,1,44,27,17,8,4,5,12,35,23,12,10,3,-1,13
New York Rangers,2013/10/29  vs. NYI,NYI,1,29,45,-16,-12,-4,0,-12,22,31,-9,-4,-5,0,-6
St. Louis Blues,2014/04/06  vs. CHI,CHI,1,32,47,-15,-2,-12,-1,-15,26,37,-11,-1,-11,1,-13
Nashville Predators,2013/11/16  vs. CHI,CHI,1,33,62,-29,-5,-24,0,-5,28,48,-20,-2,-18,0,-2
San Jose Sharks,2014/04/12  vs. PHX,PHX,1,41,60,-19,2,-21,0,-3,31,43,-12,1,-13,0,0
Phoenix Coyotes,2014/03/08  vs. WSH,WSH,1,43,42,1,5,-4,0,6,36,33,3,3,1,-1,4
Montreal Canadiens,2013/12/02  vs. NJD,NJD,1,31,54,-23,-16,3,-10,-30,19,35,-16,-10,3,-9,-21
Los Angeles Kings,2013/11/25  vs. VAN,VAN,1,37,38,-1,8,-2,-7,6,26,29,-3,2,2,-7,4
Philadelphia Flyers,2013/11/13  vs. PIT,PIT,1,34,50,-16,-7,-9,0,-8,24,37,-13,-10,-3,0,-9
Chicago Blackhawks,2014/01/11  vs. MTL,MTL,1,41,49,-8,-3,0,-5,1,26,36,-10,-5,0,-5,-3
Vancouver Canucks,2014/03/14  vs. WSH,WSH,1,50,40,10,-3,0,13,-3,37,30,7,-2,0,9,-4
Colorado Avalanche,2013/12/19  vs. EDM,EDM,1,51,42,9,6,-7,10,15,34,34,0,1,-6,5,6
New York Islanders,2013/12/23  vs. DET,DET,1,32,45,-13,0,-13,0,-1,23,35,-12,-2,-10,0,-2
Calgary Flames,2014/01/03  vs. TBL,TBL,1,41,40,1,-6,0,7,-11,25,29,-4,-4,0,0,-9
San Jose Sharks,2013/12/08  vs. MIN,MIN,1,47,30,17,11,0,6,18,34,19,15,11,0,4,18
Pittsburgh Penguins,2013/11/18  vs. ANA,ANA,1,41,42,-1,3,-4,0,3,30,33,-3,0,-3,0,0
Los Angeles Kings,2013/12/03  vs. ANA,ANA,1,73,28,45,42,0,3,42,55,22,33,30,0,3,30
New York Rangers,2013/11/04  vs. ANA,ANA,1,56,37,19,-4,0,23,8,41,27,14,-3,0,17,7
Florida Panthers,2014/01/11  vs. NJD,NJD,1,35,47,-12,-1,0,-11,-12,30,38,-8,2,0,-10,-8
Columbus Blue Jackets,2014/01/13  vs. TBL,TBL,1,44,36,8,2,3,3,2,34,27,7,1,4,2,2
Toronto Maple Leafs,2014/04/10  vs. FLA,FLA,1,36,54,-18,-3,0,-15,-15,29,45,-16,-3,0,-13,-14
Winnipeg Jets,2013/12/10  vs. STL,STL,1,25,43,-18,-14,0,-4,-17,17,25,-8,-8,0,0,-8
Winnipeg Jets,2013/11/27  vs. NYI,NYI,1,49,53,-4,9,-13,0,9,37,34,3,6,-3,0,7
Dallas Stars,2014/02/01  vs. ANA,ANA,1,42,39,3,1,2,0,13,35,29,6,2,4,0,11
Detroit Red Wings,2014/03/06  vs. COL,COL,1,55,34,21,6,15,0,18,43,27,16,5,11,0,14
New York Islanders,2014/01/12  vs. DAL,DAL,1,63,52,11,-2,2,11,1,45,42,3,-2,2,3,-4
Buffalo Sabres,2014/03/18  vs. CGY,CGY,1,33,49,-16,6,-14,-8,-8,22,37,-15,4,-13,-6,-9
Edmonton Oilers,2013/10/15  vs. PIT,PIT,1,38,41,-3,1,0,-4,-5,23,29,-6,3,0,-9,-3
Ottawa Senators,2014/01/21  vs. WSH,WSH,1,44,34,10,8,2,0,2,34,28,6,4,2,0,0
Vancouver Canucks,2014/04/05  vs. LAK,LAK,1,55,50,5,3,1,1,3,42,38,4,3,1,0,3
Anaheim Ducks,2013/11/04  vs. NYR,NYR,1,37,56,-19,4,-23,0,-8,27,41,-14,3,-17,0,-7
Phoenix Coyotes,2013/11/30  vs. CHI,CHI,1,45,45,0,-1,0,1,-6,36,33,3,0,0,3,-3
Tampa Bay Lightning,2014/02/04  vs. MIN,MIN,1,48,33,15,0,0,15,0,39,24,15,1,0,14,2
New Jersey Devils,2014/01/26  vs. NYR,NYR,1,41,34,7,-6,5,8,-1,30,29,1,-8,5,4,-2
Ottawa Senators,2014/02/06  vs. BUF,BUF,1,56,39,17,5,12,0,16,46,31,15,6,9,0,16
San Jose Sharks,2013/11/17  vs. CHI,CHI,1,40,47,-7,-3,0,-4,-8,30,34,-4,1,0,-5,-1
St. Louis Blues,2013/12/16  vs. OTT,OTT,1,44,53,-9,5,2,-16,-11,34,39,-5,6,2,-13,-7
Carolina Hurricanes,2013/12/06  vs. SJS,SJS,1,61,51,10,-2,0,12,4,43,30,13,-3,4,12,3
Columbus Blue Jackets,2013/12/10  vs. NJD,NJD,1,24,45,-21,-3,-14,-4,-10,22,37,-15,0,-12,-3,-5
Edmonton Oilers,2014/03/11  vs. MIN,MIN,1,29,38,-9,-5,0,-4,-5,24,31,-7,-3,0,-4,-2
Pittsburgh Penguins,2013/12/07  vs. BOS,BOS,1,33,28,5,3,3,-1,1,22,16,6,1,6,-1,0
Buffalo Sabres,2014/02/05  vs. PIT,PIT,1,50,48,2,0,-3,5,-3,33,35,-2,-1,-2,1,-4
Boston Bruins,2013/11/09  vs. TOR,TOR,1,51,41,10,5,5,0,-1,38,30,8,5,3,0,-1
San Jose Sharks,2014/03/22  vs. WSH,WSH,1,46,44,2,-2,3,1,-1,33,27,6,3,3,0,3
Edmonton Oilers,2013/11/07  vs. TBL,TBL,1,46,43,3,-10,0,13,-4,38,31,7,-4,0,11,3
Florida Panthers,2014/02/06  vs. DET,DET,1,30,32,-2,-8,0,6,-8,24,25,-1,-6,0,5,-7
Nashville Predators,2014/03/19  vs. VAN,VAN,1,40,41,-1,-4,0,3,-4,32,31,1,-1,0,2,-1
St. Louis Blues,2014/03/27  vs. MIN,MIN,1,30,35,-5,-2,-3,0,3,21,27,-6,-3,-3,0,1
Carolina Hurricanes,2014/03/11  vs. NYR,NYR,1,45,47,-2,-3,1,0,-4,35,32,3,-3,6,0,0
Anaheim Ducks,2013/12/20  vs. NJD,NJD,1,22,24,-2,-6,0,4,-2,18,20,-2,-5,0,3,-2
Dallas Stars,2013/11/13  vs. EDM,EDM,1,41,25,16,7,9,0,15,29,19,10,4,6,0,10
St. Louis Blues,2013/10/17  vs. CHI,CHI,1,36,38,-2,-1,0,-1,-2,27,26,1,3,0,-2,1
Washington Capitals,2013/11/29  vs. MTL,MTL,1,45,42,3,-3,0,6,1,32,33,-1,-5,0,4,-2
Anaheim Ducks,2013/11/18  vs. PIT,PIT,1,42,41,1,-3,0,4,-3,33,30,3,0,0,3,0
New York Rangers,2014/03/11  vs. CAR,CAR,1,47,45,2,3,0,-1,4,32,35,-3,3,0,-6,0
Nashville Predators,2013/10/26  vs. STL,STL,1,37,48,-11,-3,0,-8,-3,28,41,-13,-1,0,-12,-4
Washington Capitals,2014/01/28  vs. BUF,BUF,1,47,47,0,3,-3,0,10,37,35,2,5,-3,0,12
Philadelphia Flyers,2013/11/15  vs. WPG,WPG,1,31,49,-18,-13,-6,1,-12,24,39,-15,-10,-6,1,-11
Minnesota Wild,2014/04/03  vs. CHI,CHI,1,47,45,2,1,-1,2,0,32,30,2,5,-1,-2,4
Philadelphia Flyers,2013/11/23  vs. NYI,NYI,1,61,54,7,8,-1,0,8,43,37,6,6,0,0,6
St. Louis Blues,2014/01/21  vs. NJD,NJD,1,33,27,6,1,0,5,-2,24,24,0,1,0,-1,-2
New Jersey Devils,2013/12/18  vs. OTT,OTT,1,31,32,-1,1,-2,0,2,27,27,0,0,0,0,2
New York Islanders,2013/10/05  vs. CBJ,CBJ,1,42,49,-7,1,-8,0,5,31,30,1,3,-2,0,7
New York Islanders,2014/02/27  vs. TOR,TOR,1,37,36,1,-2,1,2,-2,32,26,6,1,1,4,3
Ottawa Senators,2013/11/01  vs. NYI,NYI,1,42,68,-26,-12,-14,0,-16,25,57,-32,-17,-15,0,-21
Boston Bruins,2014/01/16  vs. DAL,DAL,1,53,37,16,8,8,0,9,40,26,14,7,7,0,8
Carolina Hurricanes,2014/01/05  vs. NSH,NSH,1,50,59,-9,2,-11,0,-6,34,46,-12,1,-13,0,-10
Washington Capitals,2013/11/09  vs. PHX,PHX,1,34,38,-4,2,-4,-2,2,27,30,-3,1,-4,0,2
Tampa Bay Lightning,2013/12/12  vs. DET,DET,1,40,35,5,9,0,-4,5,34,25,9,9,0,0,9
New Jersey Devils,2014/01/21  vs. STL,STL,1,27,33,-6,-1,-5,0,2,24,24,0,-1,1,0,2
Florida Panthers,2014/01/20  vs. PIT,PIT,1,43,39,4,-1,5,0,3,32,29,3,-4,7,0,-2
Columbus Blue Jackets,2013/10/04  vs. CGY,CGY,1,55,38,17,9,0,8,12,36,30,6,3,0,3,5
New Jersey Devils,2013/11/12  vs. NYR,NYR,1,39,47,-8,0,-8,0,2,25,35,-10,-6,-4,0,-4
Washington Capitals,2013/10/03  vs. CGY,CGY,1,55,43,12,-5,0,17,-3,40,33,7,-6,0,13,-6
Montreal Canadiens,2013/10/09  vs. CGY,CGY,1,52,41,11,0,0,11,9,41,29,12,3,0,9,9
Nashville Predators,2013/12/23  vs. BOS,BOS,1,58,46,12,1,0,11,0,40,40,0,1,0,-1,-1
Colorado Avalanche,2014/01/24  vs. FLA,FLA,1,28,53,-25,0,-25,0,-2,25,47,-22,-1,-21,0,-2
Calgary Flames,2013/10/16  vs. ANA,ANA,1,43,32,11,-2,0,13,0,36,21,15,0,0,15,5
Toronto Maple Leafs,2013/10/15  vs. MIN,MIN,1,22,51,-29,0,-29,0,-13,14,38,-24,0,-24,0,-10
Colorado Avalanche,2013/10/19  vs. BUF,BUF,1,35,40,-5,11,-16,0,14,28,31,-3,8,-11,0,11
San Jose Sharks,2014/03/11  vs. TOR,TOR,1,77,27,50,17,33,0,36,58,20,38,13,25,0,26
Edmonton Oilers,2013/12/23  vs. WPG,WPG,1,38,40,-2,3,-5,0,1,32,32,0,4,-4,0,3
Buffalo Sabres,2013/11/30  vs. NJD,NJD,1,22,40,-18,-18,0,0,-18,16,30,-14,-14,0,0,-14
Anaheim Ducks,2013/10/13  vs. OTT,OTT,1,55,57,-2,0,-2,0,9,50,40,10,1,9,0,10
Detroit Red Wings,2013/11/29  vs. NYI,NYI,1,47,56,-9,-4,-5,0,-3,37,41,-4,-4,0,0,-1
Phoenix Coyotes,2014/03/29  vs. MIN,MIN,1,45,38,7,-4,9,2,6,28,30,-2,-4,2,0,0
Buffalo Sabres,2014/03/13  vs. CAR,CAR,1,34,67,-33,-30,0,-3,-28,24,48,-24,-23,2,-3,-21
Calgary Flames,2014/01/07  vs. PHX,PHX,1,50,51,-1,5,0,-6,3,36,34,2,4,0,-2,3
Detroit Red Wings,2013/12/23  vs. NYI,NYI,1,45,32,13,0,0,13,1,35,23,12,2,0,10,2
Colorado Avalanche,2013/11/29  vs. MIN,MIN,1,32,49,-17,2,-19,0,-6,21,34,-13,1,-14,0,-4
New York Rangers,2013/11/25  vs. TBL,TBL,1,54,33,21,-2,0,23,-1,33,27,6,-2,0,8,-1
Montreal Canadiens,2014/03/29  vs. FLA,FLA,1,19,45,-26,3,-29,0,1,16,38,-22,1,-23,0,-1
Ottawa Senators,2014/04/12  vs. TOR,TOR,1,57,37,20,8,12,0,12,36,31,5,3,2,0,2
Philadelphia Flyers,2014/01/22  vs. CAR,CAR,1,39,53,-14,-16,0,2,-13,31,39,-8,-11,0,3,-5
Winnipeg Jets,2014/04/07  vs. MIN,MIN,1,38,30,8,2,0,6,-2,25,19,6,1,0,5,-2
New York Islanders,2014/04/02  vs. OTT,OTT,1,40,64,-24,3,-27,0,-8,30,42,-12,4,-16,0,-2
Dallas Stars,2014/03/11  vs. STL,STL,1,41,44,-3,-6,1,2,-4,35,30,5,2,2,1,3
Washington Capitals,2014/01/09  vs. TBL,TBL,1,47,49,-2,1,-1,-2,4,32,38,-6,0,-3,-3,0
Washington Capitals,2013/12/15  vs. PHI,PHI,1,33,36,-3,-2,2,-3,-4,25,25,0,-4,2,2,-5
Dallas Stars,2013/12/03  vs. CHI,CHI,1,30,70,-40,-11,-29,0,-16,23,52,-29,-9,-20,0,-11
Buffalo Sabres,2013/11/15  vs. TOR,TOR,1,24,47,-23,-7,-16,0,-14,21,37,-16,-3,-12,-1,-10
New York Islanders,2013/11/02  vs. BOS,BOS,1,52,43,9,5,4,0,4,40,28,12,1,11,0,2
Toronto Maple Leafs,2014/03/10  vs. ANA,ANA,1,34,58,-24,0,-24,0,-2,22,41,-19,0,-19,0,1
Calgary Flames,2013/11/14  vs. DAL,DAL,1,43,59,-16,-7,0,-9,-12,31,41,-10,-5,0,-5,-10
Tampa Bay Lightning,2014/01/14  vs. NYR,NYR,1,44,52,-8,3,-8,-3,-3,27,38,-11,1,-7,-5,-10
Columbus Blue Jackets,2013/10/10  vs. BUF,BUF,1,39,46,-7,2,-9,0,2,33,33,0,4,-4,0,6
Philadelphia Flyers,2014/01/14  vs. BUF,BUF,1,46,27,19,4,0,15,10,32,21,11,1,0,10,5
Toronto Maple Leafs,2014/01/14  vs. BOS,BOS,1,23,58,-35,-12,-18,-5,-21,18,44,-26,-9,-12,-5,-16
Phoenix Coyotes,2014/01/18  vs. NJD,NJD,1,42,58,-16,3,-19,0,-9,34,37,-3,2,-5,0,1
Calgary Flames,2014/01/20  vs. SJS,SJS,1,54,57,-3,-20,4,13,-15,31,36,-5,-11,2,4,-12
Calgary Flames,2014/03/05  vs. OTT,OTT,1,24,44,-20,2,-22,0,-8,22,32,-10,1,-11,0,-3
Tampa Bay Lightning,2014/01/19  vs. CAR,CAR,1,34,76,-42,-14,-28,0,-15,27,54,-27,-8,-19,0,-8
Vancouver Canucks,2013/10/24  vs. NJD,NJD,1,27,39,-12,-16,0,4,-12,24,34,-10,-15,0,5,-10
Boston Bruins,2014/01/14  vs. TOR,TOR,1,58,23,35,12,5,18,21,44,18,26,9,5,12,16
Ottawa Senators,2013/10/17  vs. NJD,NJD,1,24,37,-13,-2,-11,0,-2,20,32,-12,-1,-11,0,-2
Minnesota Wild,2014/01/21  vs. DAL,DAL,1,34,43,-9,-15,0,6,-12,24,31,-7,-10,0,3,-8
Detroit Red Wings,2014/02/06  vs. FLA,FLA,1,32,30,2,8,-6,0,8,25,24,1,6,-5,0,7
St. Louis Blues,2014/03/15  vs. NSH,NSH,1,40,49,-9,-2,-7,0,0,30,36,-6,-2,-4,0,-2
New York Rangers,2013/11/07  vs. CBJ,CBJ,1,40,49,-9,2,-11,0,3,29,34,-5,1,-6,0,4
Vancouver Canucks,2013/12/29  vs. CGY,CGY,1,42,36,6,7,-1,0,15,35,25,10,6,4,0,17
New Jersey Devils,2014/03/02  vs. SJS,SJS,1,27,27,0,-2,2,0,-1,26,22,4,2,2,0,3
Carolina Hurricanes,2014/01/31  vs. STL,STL,1,53,42,11,-4,15,0,13,34,38,-4,-3,-1,0,2
Pittsburgh Penguins,2014/03/23  vs. STL,STL,1,46,44,2,0,0,2,0,25,34,-9,-9,0,0,-9
Washington Capitals,2014/03/29  vs. BOS,BOS,1,51,49,2,-15,0,17,-18,36,35,1,-9,0,10,-11
Buffalo Sabres,2013/11/05  vs. SJS,SJS,1,45,61,-16,-6,-11,1,-5,36,42,-6,-2,-4,0,0
New Jersey Devils,2013/12/06  vs. DET,DET,1,19,24,-5,-1,-3,-1,-4,14,22,-8,-2,-5,-1,-7
Columbus Blue Jackets,2014/03/25  vs. DET,DET,1,39,41,-2,4,-6,0,-2,29,32,-3,6,-9,0,-2
Winnipeg Jets,2013/12/31  vs. BUF,BUF,1,38,42,-4,0,-4,0,-4,27,29,-2,-2,0,0,-2
New York Islanders,2014/01/23  vs. PIT,PIT,1,55,39,16,0,-1,17,1,39,35,4,0,-4,8,-2
Phoenix Coyotes,2013/11/21  vs. COL,COL,1,65,36,29,17,-2,14,20,54,25,29,14,-2,17,19
Boston Bruins,2013/10/26  vs. NJD,NJD,1,35,33,2,3,-1,0,8,30,24,6,3,3,0,6
Philadelphia Flyers,2013/12/23  vs. MIN,MIN,1,44,43,1,-2,3,0,-2,27,35,-8,-2,-6,0,-5
Philadelphia Flyers,2013/12/28  vs. EDM,EDM,1,57,26,31,8,0,23,18,42,20,22,4,0,18,11
New Jersey Devils,2014/03/29  vs. NYI,NYI,1,45,38,7,2,0,5,7,31,26,5,3,0,2,5
Colorado Avalanche,2014/04/08  vs. EDM,EDM,1,54,42,12,1,11,0,5,43,27,16,2,14,0,7
Washington Capitals,2013/12/13  vs. FLA,FLA,1,32,56,-24,-14,0,-10,-24,22,46,-24,-16,0,-8,-24
Dallas Stars,2014/01/06  vs. NYI,NYI,1,24,47,-23,-3,-16,-4,-13,19,35,-16,-1,-15,0,-8
Minnesota Wild,2014/02/28  vs. VAN,VAN,1,28,59,-31,-31,0,0,-31,23,39,-16,-15,0,-1,-16
Vancouver Canucks,2013/10/25  vs. STL,STL,1,29,47,-18,-12,-6,0,-12,22,35,-13,-10,-3,0,-9
Florida Panthers,2013/11/07  vs. BOS,BOS,1,39,51,-12,-2,0,-10,-4,24,39,-15,-8,0,-7,-5
Calgary Flames,2014/03/08  vs. VAN,VAN,1,49,53,-4,-12,3,5,-9,25,26,-1,-5,2,2,-3
New York Rangers,2013/11/19  vs. BOS,BOS,1,69,44,25,11,0,14,22,50,27,23,9,0,14,18
Anaheim Ducks,2014/04/07  vs. VAN,VAN,1,32,52,-20,-4,-16,0,-10,21,33,-12,-3,-9,0,-4
Washington Capitals,2013/10/05  vs. DAL,DAL,1,40,45,-5,-2,-2,-1,-5,28,37,-9,-2,-1,-6,-6
Buffalo Sabres,2013/10/26  vs. TBL,TBL,1,22,42,-20,-21,1,0,-20,17,33,-16,-15,1,-2,-14
St. Louis Blues,2014/02/26  vs. VAN,VAN,1,38,43,-5,-3,0,-2,-3,29,37,-8,-5,0,-3,-5
Florida Panthers,2014/01/30  vs. TOR,TOR,1,50,41,9,-2,5,6,5,41,34,7,-1,1,7,7
Los Angeles Kings,2013/10/27  vs. EDM,EDM,1,59,21,38,33,0,5,38,49,16,33,29,0,4,33
Washington Capitals,2013/11/17  vs. STL,STL,1,36,59,-23,1,-24,0,-2,27,46,-19,-1,-18,0,-4
Tampa Bay Lightning,2013/11/12  vs. MTL,MTL,1,62,44,18,14,4,0,15,43,34,9,8,1,0,10
Columbus Blue Jackets,2014/01/28  vs. OTT,OTT,1,41,43,-2,-11,0,9,-5,30,25,5,-5,0,10,3
New York Islanders,2014/04/11  vs. NJD,NJD,1,37,38,-1,-8,-2,9,-1,31,32,-1,-8,-2,9,-1
Dallas Stars,2013/12/12  vs. NSH,NSH,1,50,38,12,3,1,8,6,35,31,4,2,1,1,3
Pittsburgh Penguins,2014/01/10  vs. EDM,EDM,1,37,44,-7,-1,-6,0,0,30,37,-7,-3,-4,0,-3
St. Louis Blues,2013/10/05  vs. FLA,FLA,1,37,32,5,1,4,0,-4,33,24,9,1,8,0,1
Montreal Canadiens,2013/11/05  vs. STL,STL,1,34,63,-29,-19,-7,-3,-23,25,32,-7,-5,-4,2,-3
Los Angeles Kings,2014/03/31  vs. MIN,MIN,1,41,37,4,-6,10,0,1,32,30,2,-5,9,-2,2
Buffalo Sabres,2013/10/10  vs. CBJ,CBJ,1,46,39,7,-2,0,9,-2,33,33,0,-4,0,4,-6
Pittsburgh Penguins,2013/11/30  vs. FLA,FLA,1,45,61,-16,-11,-5,0,-9,33,45,-12,-8,-4,0,-7
New York Rangers,2014/04/08  vs. CAR,CAR,1,60,52,8,5,3,0,4,41,36,5,0,6,-1,-2
Edmonton Oilers,2013/12/31  vs. PHX,PHX,1,38,64,-26,-13,-5,-8,-20,26,53,-27,-13,-8,-6,-23
Florida Panthers,2013/12/13  vs. WSH,WSH,1,56,32,24,14,10,0,24,46,22,24,16,8,0,24
Toronto Maple Leafs,2014/03/25  vs. STL,STL,1,34,71,-37,-15,-13,-9,-32,25,59,-34,-14,-11,-9,-26
Calgary Flames,2014/01/06  vs. COL,COL,1,40,32,8,10,-1,-1,9,30,21,9,8,2,-1,8
Calgary Flames,2013/10/30  vs. TOR,TOR,1,58,40,18,6,0,12,13,43,27,16,6,0,10,11
Montreal Canadiens,2013/11/01  vs. MIN,MIN,1,56,45,11,4,0,7,10,36,31,5,3,0,2,6
Washington Capitals,2013/10/14  vs. EDM,EDM,1,40,41,-1,-3,3,-1,-2,26,31,-5,-8,2,1,-7
Florida Panthers,2014/01/09  vs. BUF,BUF,1,49,35,14,8,0,6,10,37,26,11,5,0,6,7
Dallas Stars,2013/11/21  vs. NYR,NYR,1,66,49,17,-2,0,19,10,49,41,8,-2,0,10,5
Florida Panthers,2013/11/12  vs. ANA,ANA,1,37,36,1,8,-6,-1,10,27,32,-5,7,-7,-5,7
Phoenix Coyotes,2014/01/20  vs. TOR,TOR,1,53,36,17,7,0,10,5,42,29,13,4,0,9,2
Florida Panthers,2013/10/22  vs. CHI,CHI,1,49,59,-10,-15,0,5,-4,37,34,3,-5,0,8,2
Columbus Blue Jackets,2013/10/27  vs. ANA,ANA,1,37,36,1,-1,-2,4,3,26,26,0,-4,2,2,2
Vancouver Canucks,2013/11/19  vs. FLA,FLA,1,43,39,4,-5,1,8,3,33,28,5,-4,1,8,4
Vancouver Canucks,2013/12/13  vs. EDM,EDM,1,66,33,33,26,7,0,22,48,28,20,16,4,0,12
Ottawa Senators,2014/03/02  vs. VAN,VAN,1,36,33,3,1,-3,5,12,30,28,2,-2,0,4,8
Winnipeg Jets,2014/03/04  vs. NYI,NYI,1,47,46,1,-6,-3,10,0,33,33,0,-6,-1,7,-1
Calgary Flames,2013/11/27  vs. CHI,CHI,1,33,64,-31,-17,-13,-1,-16,26,39,-13,-8,-4,-1,-4
Anaheim Ducks,2014/03/12  vs. CGY,CGY,1,40,31,9,0,0,9,-1,27,23,4,2,0,2,0
New Jersey Devils,2014/04/10  vs. OTT,OTT,1,46,47,-1,5,0,-6,-1,35,32,3,6,0,-3,3
Nashville Predators,2014/04/12  vs. CHI,CHI,1,34,42,-8,4,2,-14,-11,28,27,1,6,2,-7,-2
Winnipeg Jets,2014/01/07  vs. TBL,TBL,1,28,47,-19,-7,-2,-10,-12,16,33,-17,-7,1,-11,-13
Edmonton Oilers,2013/11/02  vs. DET,DET,1,30,43,-13,0,0,-13,-2,19,30,-11,-1,0,-10,-3
Toronto Maple Leafs,2013/12/11  vs. LAK,LAK,1,56,46,10,3,0,7,13,40,30,10,6,0,4,12
St. Louis Blues,2013/11/17  vs. WSH,WSH,1,59,36,23,-1,0,24,2,46,27,19,1,0,18,4
Carolina Hurricanes,2013/10/08  vs. PIT,PIT,1,44,47,-3,-1,0,-2,-4,34,39,-5,-2,0,-3,-2
Winnipeg Jets,2014/03/31  vs. ANA,ANA,1,55,54,1,6,-5,0,10,38,38,0,7,-7,0,12
Chicago Blackhawks,2014/04/12  vs. NSH,NSH,1,42,34,8,-4,14,-2,11,27,28,-1,-6,7,-2,2
